"id_player","ranked","player_name","player_position","age","team","field_goal","field_goal_attempts","three_points","three_points_attempts","two_points","two_points_attempts","free_throws","free_throws_attempts","offensive_rebounds","defensive_rebounds","total_rebounds","assists","steals","blocks","turnovers","personal_fouls","points"
"achiupr01","1","Precious Achiuwa","PF","24","Toronto Raptors","78","170","13","47","65","123","24","42","50","86","136","44","16","12","29","40","193"
"achiupr01","1","Precious Achiuwa","PF","24","New York Knicks","157","299","13","50","144","249","45","70","141","210","351","53","30","56","54","103","372"
"adebaba01","2","Bam Adebayo","C","26","Miami Heat","530","1017","15","42","515","975","292","387","159","578","737","278","81","66","162","159","1367"
"agbajoc01","3","Ochai Agbaji","SG","23","Utah Jazz","106","249","47","142","59","107","15","20","35","91","126","47","27","29","34","66","274"
"agbajoc01","3","Ochai Agbaji","SG","23","Toronto Raptors","72","184","15","69","57","115","22","36","39","51","90","36","20","15","30","51","181"
"aldamsa01","4","Santi Aldama","PF","23","Memphis Grizzlies","247","568","106","304","141","264","54","87","72","280","352","138","43","54","69","89","654"
"alexani01","5","Nickeil Alexander-Walker","SG","25","Minnesota Timberwolves","236","538","131","335","105","203","52","65","35","132","167","204","64","42","76","143","655"
"allengr01","6","Grayson Allen","SG","28","Phoenix Suns","340","682","205","445","135","237","129","147","48","247","295","227","69","45","95","157","1014"
"allenja01","7","Jarrett Allen","C","25","Cleveland Cavaliers","519","819","0","6","519","813","233","314","243","568","811","210","53","81","121","147","1271"
"allenti01","8","Timmy Allen","SF","24","Memphis Grizzlies","6","23","0","7","6","16","1","2","4","13","17","5","4","0","2","18","13"
"alvarjo01","9","Jose Alvarado","PG","25","New Orleans Pelicans","142","345","78","207","64","138","35","52","25","103","128","117","59","15","40","89","397"
"anderky01","10","Kyle Anderson","PF","30","Minnesota Timberwolves","199","433","11","48","188","385","97","137","60","213","273","331","71","47","91","128","506"
"antetgi01","11","Giannis Antetokounmpo","PF","29","Milwaukee Bucks","837","1369","34","124","803","1245","514","782","196","645","841","476","87","79","250","210","2222"
"antetth01","12","Thanasis Antetokounmpo","PF","31","Milwaukee Bucks","16","30","0","1","16","29","0","2","7","6","13","17","7","4","14","24","32"
"anthoco01","13","Cole Anthony","PG","23","Orlando Magic","332","763","93","275","239","488","180","218","64","247","311","236","64","37","126","175","937"
"anunoog01","14","OG Anunoby","SF","26","Toronto Raptors","157","321","61","163","96","158","33","46","24","82","106","72","28","13","43","62","408"
"anunoog01","14","OG Anunoby","SF","26","New York Knicks","125","256","41","104","84","152","34","43","23","79","102","35","40","23","38","57","325"
"arcidry01","15","Ryan Arcidiacono","PG","29","New York Knicks","0","6","0","6","0","0","0","0","0","8","8","4","2","0","2","5","0"
"avdijde01","16","Deni Avdija","SF","23","Washington Wizards","406","803","88","235","318","568","202","273","84","456","540","286","60","36","160","185","1102"
"aytonde01","17","Deandre Ayton","C","25","Portland Trail Blazers","427","749","1","10","426","739","65","79","176","433","609","90","56","42","99","109","920"
"azubuud01","18","Udoka Azubuike","C","24","Phoenix Suns","16","23","0","0","16","23","3","13","11","21","32","3","1","6","4","17","35"
"badjiib01","19","Ibou Badji","C","21","Portland Trail Blazers","14","22","0","0","14","22","6","12","20","31","51","13","3","20","15","46","34"
"baglema01","20","Marvin Bagley III","C","24","Detroit Pistons","107","181","1","6","106","175","50","61","46","72","118","27","5","14","29","40","265"
"baglema01","20","Marvin Bagley III","C","24","Washington Wizards","132","227","8","17","124","210","46","65","84","110","194","28","15","19","30","41","318"
"baileam01","21","Amari Bailey","PG","19","Charlotte Hornets","8","24","1","8","7","16","6","7","6","3","9","7","3","0","4","2","23"
"baldwpa01","22","Patrick Baldwin Jr.","SF","21","Washington Wizards","59","155","31","97","28","58","19","28","17","106","123","29","18","15","19","56","168"
"ballla01","23","LaMelo Ball","PG","22","Charlotte Hornets","183","423","70","197","113","226","90","104","29","84","113","176","40","4","83","79","526"
"bambamo01","24","Mo Bamba","C","25","Philadelphia 76ers","97","198","25","64","72","134","34","50","77","161","238","41","22","60","39","101","253"
"banchpa01","25","Paolo Banchero","PF","21","Orlando Magic","640","1407","119","351","521","1056","405","559","82","472","554","431","71","47","247","153","1804"
"banede01","26","Desmond Bane","SG","25","Memphis Grizzlies","360","776","137","360","223","416","140","161","36","149","185","230","43","22","112","120","997"
"bantoda01","27","Dalano Banton","PG","24","Boston Celtics","19","51","2","16","17","35","16","20","12","23","35","19","5","3","10","20","56"
"bantoda01","27","Dalano Banton","PG","24","Portland Trail Blazers","183","449","57","183","126","266","78","100","29","114","143","108","28","17","67","44","501"
"barlodo01","28","Dominick Barlow","PF","20","San Antonio Spurs","56","113","3","9","53","104","29","42","45","68","113","36","12","14","9","47","144"
"barneha02","29","Harrison Barnes","PF","31","Sacramento Kings","347","732","149","385","198","347","157","196","67","182","249","99","54","12","58","98","1000"
"barnesc01","30","Scottie Barnes","SG","22","Toronto Raptors","447","942","101","296","346","646","196","251","141","353","494","363","75","88","165","118","1191"
"barrerj01","31","RJ Barrett","SG","23","New York Knicks","164","388","43","130","121","258","103","124","19","92","111","63","12","9","47","45","474"
"barrerj01","31","RJ Barrett","SG","23","Toronto Raptors","272","492","47","120","225","372","105","167","34","170","204","130","19","13","79","84","696"
"bassech01","32","Charles Bassey","C","23","San Antonio Spurs","29","40","0","1","29","39","5","6","23","53","76","21","8","17","15","31","63"
"batesem01","33","Emoni Bates","SF","20","Cleveland Cavaliers","15","49","10","33","5","16","1","4","1","13","14","10","1","2","8","5","41"
"bateske01","34","Keita Bates-Diop","SF","28","Phoenix Suns","64","150","20","64","44","86","26","36","30","71","101","34","22","20","13","33","174"
"bateske01","34","Keita Bates-Diop","SF","28","Brooklyn Nets","8","16","1","5","7","11","6","6","1","8","9","4","3","2","2","2","23"
"batumni01","35","Nicolas Batum","PF","35","Los Angeles Clippers","3","8","2","7","1","1","0","0","0","7","7","5","3","4","1","5","8"
"batumni01","35","Nicolas Batum","PF","35","Philadelphia 76ers","113","248","71","178","42","70","15","21","70","171","241","123","45","34","39","104","312"
"bazleda01","36","Darius Bazley","PF","23","Philadelphia 76ers","0","1","0","0","0","1","0","0","0","1","1","2","0","0","1","0","0"
"bazleda01","36","Darius Bazley","PF","23","Utah Jazz","18","29","2","8","16","21","10","12","8","19","27","5","6","7","7","3","48"
"bealbr01","37","Bradley Beal","SG","30","Phoenix Suns","377","735","101","235","276","500","109","134","54","178","232","265","52","27","131","127","964"
"beaslma01","38","Malik Beasley","SG","27","Milwaukee Bucks","320","722","224","542","96","180","25","35","41","249","290","108","59","9","54","158","889"
"beaucma01","39","MarJon Beauchamp","SF","23","Milwaukee Bucks","81","166","30","75","51","91","19","28","22","77","99","31","13","7","27","54","211"
"bernaju01","40","Jules Bernard","SG","24","Washington Wizards","29","64","11","29","18","35","5","9","10","16","26","16","3","1","8","14","74"
"bertada01","41","Davis Bertans","PF","31","Oklahoma City Thunder","10","26","10","24","0","2","14","15","2","8","10","9","3","3","1","10","44"
"bertada01","41","Davis Bertans","PF","31","Charlotte Hornets","82","208","66","176","16","32","16","18","7","44","51","26","23","9","17","46","246"
"beverpa01","42","Patrick Beverley","PG","35","Philadelphia 76ers","104","241","35","109","69","132","51","63","30","115","145","144","24","18","49","83","294"
"beverpa01","42","Patrick Beverley","PG","35","Milwaukee Bucks","54","138","26","72","28","66","23","27","19","75","94","68","19","13","16","45","157"
"beysa01","43","Saddiq Bey","SF","24","Atlanta Hawks","290","697","113","358","177","339","170","203","167","244","411","92","51","11","54","88","863"
"bitadgo01","44","Goga Bitadze","C","24","Orlando Magic","126","209","2","14","124","195","57","87","109","177","286","79","32","72","44","107","311"
"bitimon01","45","Onuralp Bitim","SG","24","Chicago Bulls","32","84","12","44","20","40","4","5","6","26","32","13","3","2","10","24","80"
"biyombi01","46","Bismack Biyombo","C","31","Memphis Grizzlies","67","119","0","0","67","119","22","46","57","134","191","51","10","34","38","82","156"
"biyombi01","46","Bismack Biyombo","C","31","Oklahoma City Thunder","7","12","0","0","7","12","4","8","5","13","18","2","1","3","4","7","18"
"blackan01","47","Anthony Black","PG","20","Orlando Magic","115","247","37","94","78","153","49","80","33","106","139","91","35","21","56","110","316"
"blackle01","48","Leaky Black","SF","24","Charlotte Hornets","25","52","9","20","16","32","10","15","9","39","48","24","8","11","6","19","69"
"boehebu01","49","Buddy Boeheim","SF","24","Detroit Pistons","9","29","8","25","1","4","8","10","3","7","10","3","0","1","0","5","34"
"bogdabo01","50","Bogdan Bogdanovic","SG","31","Atlanta Hawks","471","1100","240","641","231","459","151","164","53","219","272","247","96","26","112","179","1333"
"bogdabo02","51","Bojan Bogdanovic","PF","34","Detroit Pistons","199","425","86","207","113","218","81","104","13","81","94","71","23","4","63","57","565"
"bogdabo02","51","Bojan Bogdanovic","SF","34","New York Knicks","110","256","47","127","63","129","36","45","9","49","58","26","7","1","38","38","303"
"bolbo01","52","Bol Bol","PF","24","Phoenix Suns","93","151","22","52","71","99","15","19","32","105","137","17","10","25","19","42","223"
"boldema01","53","Marques Bolden","C","25","Milwaukee Bucks","0","0","0","0","0","0","0","0","0","2","2","0","0","0","0","1","0"
"boldema01","53","Marques Bolden","C","25","Charlotte Hornets","17","25","0","1","17","24","3","4","10","22","32","4","3","7","3","9","37"
"bookede01","54","Devin Booker","PG","27","Phoenix Suns","642","1305","152","418","490","887","405","457","56","252","308","472","61","28","178","206","1841"
"bostobr01","55","Brandon Boston Jr.","SF","22","Los Angeles Clippers","65","161","14","52","51","109","23","33","19","33","52","13","11","8","24","40","167"
"bouchch01","56","Chris Boucher","PF","31","Toronto Raptors","110","217","31","94","79","123","71","92","62","145","207","23","14","24","28","68","322"
"bouknja01","57","James Bouknight","SG","23","Charlotte Hornets","18","41","13","30","5","11","1","2","1","8","9","6","1","1","2","3","50"
"bouyeja01","58","Jamaree Bouyea","PG","24","Portland Trail Blazers","5","21","0","8","5","13","0","0","2","8","10","8","0","0","8","3","10"
"bouyeja01","58","Jamaree Bouyea","PG","24","San Antonio Spurs","5","7","1","1","4","6","0","0","1","8","9","3","1","0","1","7","11"
"branhma01","59","Malaki Branham","PG","20","San Antonio Spurs","271","628","93","268","178","360","55","63","28","120","148","156","27","8","91","94","690"
"braunch01","60","Christian Braun","SG","22","Denver Nuggets","222","483","63","164","159","319","93","134","79","227","306","132","42","35","55","137","600"
"bridgmi01","61","Mikal Bridges","SF","27","Brooklyn Nets","564","1294","220","592","344","702","258","317","68","304","372","299","81","30","164","116","1606"
"bridgmi02","62","Miles Bridges","SF","25","Charlotte Hornets","559","1210","157","450","402","760","174","211","71","434","505","231","65","33","138","118","1449"
"brissos01","63","Oshae Brissett","SF","25","Boston Celtics","68","153","15","55","53","98","50","83","61","99","160","44","19","8","20","54","201"
"brockiz01","64","Izaiah Brockington","PG","24","New Orleans Pelicans","2","5","0","1","2","4","0","0","1","1","2","0","0","0","0","0","4"
"brogdma01","65","Malcolm Brogdon","PG","31","Portland Trail Blazers","218","496","82","199","136","297","95","116","28","120","148","214","27","8","60","58","613"
"brookar01","66","Armoni Brooks","PG","25","Brooklyn Nets","15","46","11","32","4","14","1","2","7","11","18","5","1","1","3","3","42"
"brookdi01","67","Dillon Brooks","SF","28","Houston Rockets","329","768","133","370","196","398","124","147","53","193","246","119","64","10","88","241","915"
"brownbr01","68","Bruce Brown","SG","27","Indiana Pacers","149","314","33","101","116","213","67","82","25","129","154","100","35","8","41","81","398"
"brownbr01","68","Bruce Brown","PG","27","Toronto Raptors","129","268","20","63","109","205","50","60","28","102","130","92","24","9","45","67","328"
"brownch02","69","Charlie Brown Jr.","SG","26","New York Knicks","2","10","2","7","0","3","0","0","1","1","2","0","0","2","2","5","6"
"browngr01","70","Greg Brown III","PF","22","Dallas Mavericks","5","11","1","3","4","8","4","9","3","6","9","4","0","4","4","5","15"
"brownja02","71","Jaylen Brown","SF","27","Boston Celtics","627","1256","145","410","482","846","211","300","84","303","387","249","83","37","166","185","1610"
"brownke03","72","Kendall Brown","SG","20","Indiana Pacers","8","15","0","2","8","13","5","8","3","2","5","5","0","0","2","9","21"
"brownko01","73","Kobe Brown","PF","24","Los Angeles Clippers","37","90","14","48","23","42","1","2","20","42","62","25","12","6","9","49","89"
"brownmo01","74","Moses Brown","C","24","Portland Trail Blazers","33","65","0","0","33","65","9","31","37","49","86","7","5","7","11","27","75"
"browntr01","75","Troy Brown Jr.","SF","24","Minnesota Timberwolves","52","118","31","84","21","34","19","22","14","58","72","35","8","2","18","26","154"
"browntr01","75","Troy Brown Jr.","SF","24","Detroit Pistons","32","108","16","57","16","51","13","15","11","61","72","25","16","1","12","16","93"
"brunsja01","76","Jalen Brunson","PG","27","New York Knicks","790","1648","211","526","579","1122","421","497","43","235","278","519","70","13","186","144","2212"
"bryanth01","77","Thomas Bryant","C","26","Miami Heat","86","149","4","22","82","127","41","47","40","101","141","23","10","16","21","46","217"
"bufkiko01","78","Kobe Bufkin","SG","20","Atlanta Hawks","34","92","9","40","25","52","4","8","6","27","33","27","7","5","10","20","81"
"bullore01","79","Reggie Bullock","SF","32","Houston Rockets","34","82","27","67","7","15","1","1","6","67","73","15","12","5","10","29","96"
"burksal01","80","Alec Burks","SG","32","Detroit Pistons","160","406","99","247","61","159","121","134","16","94","110","68","21","11","32","64","540"
"burksal01","80","Alec Burks","SG","32","New York Knicks","50","163","25","83","25","80","24","33","8","32","40","20","7","1","16","11","149"
"butleja02","81","Jared Butler","SG","23","Washington Wizards","98","201","24","78","74","123","31","36","9","49","58","126","29","8","50","58","251"
"butleji01","82","Jimmy Butler","PF","34","Miami Heat","396","793","60","145","336","648","394","459","105","213","318","298","79","17","102","68","1246"
"cainja01","83","Jamal Cain","PF","24","Miami Heat","34","79","11","31","23","48","18","23","15","22","37","10","10","5","8","22","97"
"caldwke01","84","Kentavious Caldwell-Pope","SG","30","Denver Nuggets","270","587","125","308","145","279","101","113","31","152","183","183","98","42","75","151","766"
"camarto01","85","Toumani Camara","PF","23","Portland Trail Blazers","197","438","58","172","139","266","75","99","139","204","343","87","66","33","84","174","527"
"capelca01","86","Clint Capela","C","29","Atlanta Hawks","353","618","0","1","353","617","130","206","335","441","776","91","43","106","74","164","836"
"carteje01","87","Jevon Carter","PG","28","Chicago Bulls","138","365","77","234","61","131","4","7","11","49","60","94","37","16","36","71","357"
"cartewe01","88","Wendell Carter Jr.","C","24","Orlando Magic","223","425","64","171","159","254","93","134","112","269","381","95","35","28","68","121","603"
"cartodj01","89","D.J. Carton","SG","23","Toronto Raptors","3","8","1","4","2","4","4","5","2","2","4","3","1","0","1","3","11"
"carusal01","90","Alex Caruso","SG","29","Chicago Bulls","253","541","136","333","117","208","73","96","62","211","273","247","120","70","102","181","715"
"castlco01","91","Colin Castleton","C","23","Los Angeles Lakers","9","16","0","0","9","16","6","6","6","6","12","3","2","0","3","11","24"
"cazalma01","92","Malcolm Cazalon","SG","22","Detroit Pistons","0","0","0","0","0","0","0","0","0","0","0","0","0","0","0","0","0"
"champju02","93","Julian Champagnie","SF","22","San Antonio Spurs","164","402","101","277","63","125","75","92","42","164","206","103","48","42","57","77","504"
"champju01","94","Justin Champagnie","SF","22","Washington Wizards","32","78","13","45","19","33","12","15","19","34","53","19","10","9","10","14","89"
"chrisma02","95","Max Christie","SG","20","Los Angeles Lakers","103","241","42","118","61","123","36","46","15","127","142","60","20","17","35","57","284"
"cissosi01","96","Sidy Cissoko","SF","19","San Antonio Spurs","16","33","1","12","15","21","12","15","8","14","22","10","7","3","3","18","45"
"clarkbr01","97","Brandon Clarke","PF","27","Memphis Grizzlies","33","59","1","6","32","53","1","7","13","19","32","9","5","6","3","8","68"
"clarkjo01","98","Jordan Clarkson","SG","31","Utah Jazz","337","816","91","309","246","507","177","201","49","139","188","277","35","6","146","81","942"
"claxtni01","99","Nic Claxton","C","24","Brooklyn Nets","366","582","1","5","365","577","108","196","193","513","706","147","46","146","93","175","841"
"clownno01","100","Noah Clowney","PF","19","Brooklyn Nets","50","93","12","33","38","60","21","30","26","55","81","18","8","16","15","25","133"
"coffeam01","101","Amir Coffey","SF","26","Los Angeles Clippers","166","352","70","184","96","168","61","71","29","119","148","76","41","14","33","102","463"
"collijo01","102","John Collins","PF","26","Utah Jazz","397","746","86","232","311","514","147","185","157","418","575","77","40","61","98","191","1027"
"colliza01","103","Zach Collins","C","26","San Antonio Spurs","298","616","58","181","240","435","122","162","118","252","370","194","34","52","132","206","776"
"conlemi01","104","Mike Conley","PG","36","Minnesota Timberwolves","294","644","179","405","115","239","102","112","37","181","218","449","88","17","102","128","869"
"connapa01","105","Pat Connaughton","SF","31","Milwaukee Bucks","151","347","82","238","69","109","44","58","51","188","239","161","40","19","49","99","428"
"coulibi01","106","Bilal Coulibaly","SF","19","Washington Wizards","188","432","64","185","124","247","92","131","56","200","256","110","57","48","87","137","532"
"councri01","107","Ricky Council IV","SG","22","Philadelphia 76ers","54","112","12","32","42","80","53","71","14","32","46","16","8","1","5","17","173"
"covinro01","108","Robert Covington","PF","33","Los Angeles Clippers","3","9","2","8","1","1","1","2","2","6","8","7","6","2","0","7","9"
"covinro01","108","Robert Covington","SF","33","Philadelphia 76ers","40","89","17","48","23","41","21","24","29","60","89","17","33","16","11","49","118"
"craigto01","109","Torrey Craig","SF","33","Chicago Bulls","108","251","60","153","48","98","27","36","69","148","217","58","30","21","32","110","303"
"crowdja01","110","Jae Crowder","PF","33","Milwaukee Bucks","114","270","58","166","56","104","26","36","31","130","161","66","38","9","23","74","312"
"crutcja01","111","Jalen Crutcher","PG","24","New Orleans Pelicans","0","1","0","0","0","1","0","0","0","0","0","0","0","0","0","0","0"
"cunnica01","112","Cade Cunningham","PG","22","Detroit Pistons","524","1167","119","335","405","832","238","274","33","235","268","464","56","22","212","153","1405"
"curryse01","113","Seth Curry","SG","33","Dallas Mavericks","54","145","29","80","25","65","17","19","15","37","52","30","17","3","16","32","154"
"curryse01","113","Seth Curry","SG","33","Charlotte Hornets","26","59","9","28","17","31","11","12","3","13","16","14","5","3","5","7","72"
"curryst01","114","Stephen Curry","PG","35","Golden State Warriors","650","1445","357","876","293","569","299","324","37","293","330","379","54","28","210","117","1956"
"daniedy01","115","Dyson Daniels","PG","20","New Orleans Pelicans","139","311","42","135","97","176","34","53","62","174","236","164","85","25","59","101","354"
"davisan02","116","Anthony Davis","C","30","Los Angeles Lakers","713","1283","29","107","684","1176","421","516","239","722","961","266","91","178","159","177","1876"
"davisjo06","117","Johnny Davis","SG","21","Washington Wizards","62","154","14","40","48","114","14","24","18","54","72","32","18","10","13","57","152"
"davisjd01","118","JD Davison","SG","21","Boston Celtics","5","12","3","7","2","5","3","4","2","8","10","10","1","1","2","4","16"
"dennide01","119","Dexter Dennis","SG","24","Dallas Mavericks","10","19","1","8","9","11","1","3","1","8","9","4","0","1","3","1","22"
"derozde01","120","DeMar DeRozan","SF","34","Chicago Bulls","650","1355","75","225","575","1130","522","612","43","297","340","421","90","45","135","161","1897"
"diabamo01","121","Moussa Diabate","C","22","Los Angeles Clippers","10","19","0","0","10","19","9","14","15","9","24","4","5","1","2","4","29"
"diakima01","122","Mamadi Diakite","PF","27","San Antonio Spurs","4","5","0","0","4","5","4","6","1","2","3","2","0","1","0","1","12"
"diakima01","122","Mamadi Diakite","PF","27","New York Knicks","0","1","0","1","0","0","0","0","0","1","1","0","1","0","1","1","0"
"diallha01","123","Hamidou Diallo","SG","25","Washington Wizards","1","2","0","0","1","2","0","0","2","0","2","1","2","0","1","1","2"
"dickgr01","124","Gradey Dick","SG","20","Toronto Raptors","189","445","88","241","101","204","44","51","27","105","132","68","34","2","50","87","510"
"diengou01","125","Ousmane Dieng","PF","20","Oklahoma City Thunder","49","116","21","70","28","46","14","16","10","41","51","37","8","5","19","22","133"
"dinwisp01","126","Spencer Dinwiddie","PG","30","Brooklyn Nets","195","499","89","278","106","221","125","160","26","132","158","288","38","9","62","86","604"
"dinwisp01","126","Spencer Dinwiddie","PG","30","Los Angeles Lakers","56","141","35","90","21","51","44","50","4","43","47","68","13","13","29","52","191"
"divindo01","127","Donte DiVincenzo","SG","27","New York Knicks","445","1004","283","705","162","299","86","114","63","234","297","216","107","36","113","166","1259"
"doncilu01","128","Luka Doncic","PG","24","Dallas Mavericks","804","1652","284","744","520","908","478","608","59","588","647","686","99","38","282","149","2370"
"dortlu01","129","Luguentz Dort","SF","24","Oklahoma City Thunder","288","657","156","396","132","261","128","155","74","210","284","113","72","47","74","228","860"
"dosunay01","130","Ayo Dosunmu","SG","24","Chicago Bulls","360","719","119","295","241","424","85","105","54","162","216","242","68","36","103","166","924"
"dowtije01","131","Jeff Dowtin","PG","26","Philadelphia 76ers","20","36","9","19","11","17","3","4","3","17","20","27","7","1","5","1","52"
"drellhe01","132","Henri Drell","SF","23","Chicago Bulls","4","10","2","6","2","4","1","2","1","3","4","4","2","1","2","6","11"
"drumman01","133","Andre Drummond","C","30","Chicago Bulls","267","480","0","3","267","477","129","218","265","443","708","37","73","48","81","140","663"
"duartch01","134","Chris Duarte","SF","26","Sacramento Kings","80","210","44","127","36","83","26","33","26","80","106","44","28","8","26","80","230"
"dukeda01","135","David Duke Jr.","SG","24","San Antonio Spurs","10","18","3","6","7","12","3","3","2","8","10","5","2","0","3","4","26"
"dunnkr01","136","Kris Dunn","PG","29","Utah Jazz","147","313","41","111","106","202","22","32","50","139","189","254","68","28","79","135","357"
"duranke01","137","Kevin Durant","PF","35","Phoenix Suns","751","1436","168","407","583","1029","362","423","41","454","495","378","69","91","244","133","2032"
"durenja01","138","Jalen Duren","C","20","Detroit Pistons","349","564","0","4","349","560","143","181","192","517","709","147","33","47","129","192","841"
"easonta01","139","Tari Eason","PF","22","Houston Rockets","88","189","18","50","70","139","21","33","46","107","153","27","31","19","20","51","215"
"edwaran01","140","Anthony Edwards","SG","22","Minnesota Timberwolves","718","1558","190","532","528","1026","423","506","52","378","430","405","101","42","241","141","2049"
"edwarke02","141","Kessler Edwards","SF","23","Sacramento Kings","34","82","20","52","14","30","5","9","9","33","42","15","10","4","4","26","93"
"elliske01","142","Keon Ellis","SG","24","Sacramento Kings","107","232","70","168","37","64","26","35","32","92","124","85","51","29","37","112","310"
"embiijo01","143","Joel Embiid","C","29","Philadelphia 76ers","450","851","54","139","396","712","399","452","95","335","430","219","46","66","150","112","1353"
"eubandr01","144","Drew Eubanks","C","26","Phoenix Suns","152","253","3","3","149","250","72","93","103","219","322","63","27","61","61","115","379"
"evbuoto01","145","Tosan Evbuomwan","SF","22","Memphis Grizzlies","4","15","2","8","2","7","0","0","8","6","14","6","0","1","1","5","10"
"evbuoto01","145","Tosan Evbuomwan","SF","22","Detroit Pistons","32","56","10","24","22","32","17","25","10","36","46","10","6","4","8","18","91"
"exumda01","146","Dante Exum","PG","28","Dallas Mavericks","161","302","53","108","108","194","53","68","25","124","149","157","22","5","49","85","428"
"fernabr01","147","Bruno Fernando","C","25","Atlanta Hawks","109","187","0","4","109","183","64","96","59","134","193","46","25","28","44","107","282"
"finnedo01","148","Dorian Finney-Smith","PF","30","Brooklyn Nets","215","511","117","336","98","175","33","46","109","208","317","107","56","38","59","150","580"
"flaglad01","149","Adam Flagler","SG","24","Oklahoma City Thunder","1","7","1","6","0","1","0","0","0","0","0","4","0","0","0","0","3"
"flynnma01","150","Malachi Flynn","PG","25","Toronto Raptors","56","137","28","80","28","57","17","22","13","52","65","73","18","6","33","42","157"
"flynnma01","150","Malachi Flynn","PG","25","New York Knicks","9","23","4","13","5","10","9","11","0","6","6","6","1","0","3","3","31"
"flynnma01","150","Malachi Flynn","PG","25","Detroit Pistons","71","165","24","76","47","89","26","38","8","35","43","51","19","2","27","21","192"
"fontesi01","151","Simone Fontecchio","SF","28","Utah Jazz","161","358","91","233","70","125","32","40","52","124","176","73","30","18","51","81","445"
"fontesi01","151","Simone Fontecchio","SF","28","Detroit Pistons","91","190","43","101","48","89","22","26","12","58","70","28","14","5","17","29","247"
"fordjo01","152","Jordan Ford","PG","25","Sacramento Kings","4","7","2","3","2","4","2","2","0","2","2","2","0","0","1","0","12"
"forretr01","153","Trent Forrest","SG","25","Atlanta Hawks","34","90","2","10","32","80","13","17","11","40","51","92","11","3","20","25","83"
"fournev01","154","Evan Fournier","SG","31","New York Knicks","4","20","2","15","2","5","2","2","0","4","4","3","4","0","1","4","12"
"fournev01","154","Evan Fournier","SG","31","Detroit Pistons","75","201","31","115","44","86","27","34","5","49","54","45","25","7","20","44","208"
"foxde01","155","DeAaron Fox","PG","26","Sacramento Kings","720","1549","214","580","506","969","312","423","67","273","340","418","150","31","194","193","1966"
"freemja01","156","Javon Freeman-Liberty","PG","24","Toronto Raptors","55","124","10","42","45","82","33","36","16","54","70","40","10","4","25","28","153"
"fudgeal01","157","Alex Fudge","SF","20","Los Angeles Lakers","1","6","0","2","1","4","2","2","2","0","2","0","0","0","1","1","4"
"fudgeal01","157","Alex Fudge","SF","20","Dallas Mavericks","5","9","1","3","4","6","0","0","2","1","3","0","3","0","1","1","11"
"fultzma01","158","Markelle Fultz","PG","25","Orlando Magic","154","326","4","18","150","308","23","33","56","82","138","120","42","15","50","65","335"
"funkan01","159","Andrew Funk","SG","24","Chicago Bulls","0","4","0","3","0","1","0","0","0","0","0","0","1","1","0","0","0"
"gabriwe01","160","Wenyen Gabriel","PF","26","Memphis Grizzlies","8","22","1","6","7","16","0","5","7","18","25","3","2","2","8","10","17"
"gaffoda01","161","Daniel Gafford","C","25","Washington Wizards","203","294","0","0","203","294","84","119","131","230","361","69","44","97","46","147","490"
"gaffoda01","161","Daniel Gafford","PF","25","Dallas Mavericks","145","186","0","0","145","186","34","56","64","137","201","46","21","56","28","80","324"
"gallida01","162","Danilo Gallinari","PF","35","Washington Wizards","57","131","20","64","37","67","47","56","12","64","76","31","6","3","12","26","181"
"gallida01","162","Danilo Gallinari","SF","35","Detroit Pistons","12","22","7","12","5","10","21","24","2","12","14","12","2","2","1","9","52"
"gallida01","162","Danilo Gallinari","SF","35","Milwaukee Bucks","14","37","3","17","11","20","16","18","6","12","18","12","6","1","10","15","47"
"garlada01","163","Darius Garland","PG","24","Cleveland Cavaliers","375","841","132","356","243","485","146","175","30","122","152","373","74","7","176","95","1028"
"garubus01","164","Usman Garuba","PF","21","Golden State Warriors","1","6","0","1","1","5","1","2","3","4","7","1","1","3","2","2","3"
"garzalu01","165","Luka Garza","C","25","Minnesota Timberwolves","36","75","9","32","27","43","18","25","19","12","31","4","4","1","6","24","99"
"gateska01","166","Kaiser Gates","SF","27","New Orleans Pelicans","0","4","0","2","0","2","0","0","0","1","1","0","0","0","0","0","0"
"georgke01","167","Keyonte George","PG","20","Utah Jazz","319","815","147","440","172","375","189","223","15","196","211","332","36","7","188","91","974"
"georgpa01","168","Paul George","PF","33","Los Angeles Clippers","582","1236","243","588","339","648","264","291","37","351","388","262","113","37","153","202","1671"
"gibsota01","169","Taj Gibson","PF","38","New York Knicks","7","23","0","6","7","17","2","2","10","18","28","9","2","6","5","28","16"
"gibsota01","169","Taj Gibson","PF","38","Detroit Pistons","8","14","2","4","6","10","0","0","2","7","9","2","1","1","0","3","18"
"giddejo01","170","Josh Giddey","SG","21","Oklahoma City Thunder","402","847","82","243","320","604","100","124","111","403","514","386","51","44","168","111","986"
"gilesha01","171","Harry Giles","C","25","Brooklyn Nets","22","44","3","11","19","33","7","13","12","14","26","6","1","3","6","15","54"
"gilesha01","171","Harry Giles","C","25","Los Angeles Lakers","1","6","0","3","1","3","0","0","0","4","4","0","1","0","0","0","2"
"gilgesh01","172","Shai Gilgeous-Alexander","PG","25","Oklahoma City Thunder","796","1487","95","269","701","1218","567","649","65","350","415","465","150","67","162","184","2254"
"gillan01","173","Anthony Gill","PF","31","Washington Wizards","75","160","10","41","65","119","29","36","37","57","94","34","13","11","23","48","189"
"gilleco01","174","Collin Gillespie","PG","24","Denver Nuggets","32","69","15","38","17","31","8","12","1","20","21","27","13","0","14","24","87"
"gilyaja01","175","Jacob Gilyard","PG","25","Memphis Grizzlies","60","144","51","120","9","24","2","2","8","35","43","131","27","5","29","35","173"
"gilyaja01","175","Jacob Gilyard","PG","25","Brooklyn Nets","0","6","0","6","0","0","0","0","1","2","3","6","6","0","1","4","0"
"goberru01","176","Rudy Gobert","C","31","Minnesota Timberwolves","406","614","0","3","406","611","249","390","285","697","982","102","52","162","118","238","1061"
"goodwjo01","177","Jordan Goodwin","PG","25","Phoenix Suns","75","193","23","80","52","113","25","29","40","77","117","78","23","9","29","43","198"
"goodwjo01","177","Jordan Goodwin","PG","25","Memphis Grizzlies","66","189","19","61","47","128","19","30","48","88","136","77","25","9","27","33","170"
"gordoaa01","178","Aaron Gordon","PF","28","Denver Nuggets","398","716","40","138","358","578","177","269","174","297","471","259","56","45","105","142","1013"
"gordoer01","179","Eric Gordon","SG","35","Phoenix Suns","274","618","150","397","124","221","51","64","16","106","122","139","66","30","73","79","749"
"grahade01","180","Devonte Graham","PG","28","San Antonio Spurs","38","108","25","83","13","25","13","16","5","31","36","49","9","2","17","14","114"
"grantje01","181","Jerami Grant","PF","29","Portland Trail Blazers","383","850","111","276","272","574","255","312","37","154","191","152","45","34","116","117","1132"
"grayra01","182","RaiQuan Gray","PF","24","San Antonio Spurs","10","17","3","7","7","10","0","0","2","5","7","6","1","1","1","0","23"
"greenaj01","183","A.J. Green","SG","24","Milwaukee Bucks","83","196","69","169","14","27","17","19","9","55","64","30","9","4","12","49","252"
"greenda02","184","Danny Green","SG","36","Philadelphia 76ers","0","2","0","1","0","1","0","0","0","2","2","1","1","0","0","1","0"
"greendr01","185","Draymond Green","PF","33","Golden State Warriors","185","372","51","129","134","243","54","74","76","322","398","332","55","47","135","166","475"
"greenja05","186","Jalen Green","SG","21","Houston Rockets","563","1332","201","605","362","727","283","352","41","382","423","291","66","28","191","115","1610"
"greenja02","187","Javonte Green","SF","30","Chicago Bulls","45","75","10","27","35","48","10","13","20","47","67","5","10","8","7","19","110"
"greenje02","188","Jeff Green","PF","37","Houston Rockets","167","366","53","160","114","206","122","149","46","132","178","70","16","31","46","100","509"
"greenjo02","189","Josh Green","SG","23","Dallas Mavericks","179","374","72","187","107","187","39","57","40","144","184","130","47","9","60","107","469"
"griffaj01","190","AJ Griffin","SF","20","Atlanta Hawks","18","62","10","39","8","23","2","2","2","16","18","5","1","2","8","6","48"
"grimequ01","191","Quentin Grimes","SG","23","New York Knicks","113","286","77","212","36","74","24","34","14","74","88","52","30","3","21","66","327"
"grimequ01","191","Quentin Grimes","SG","23","Detroit Pistons","9","42","4","28","5","14","10","11","1","11","12","14","5","4","7","9","32"
"gueyemo01","192","Mouhamadou Gueye","PF","25","Toronto Raptors","11","38","0","3","11","35","4","9","12","11","23","5","3","18","12","15","26"
"gueyemo02","193","Mouhamed Gueye","PF","21","Atlanta Hawks","8","23","3","9","5","14","5","6","10","12","22","4","5","4","1","13","24"
"hachiru01","194","Rui Hachimura","PF","25","Los Angeles Lakers","363","676","98","232","265","444","99","134","58","236","294","81","41","25","46","101","923"
"haganas01","195","Ashton Hagans","PG","24","Portland Trail Blazers","29","71","8","25","21","46","14","17","14","31","45","54","11","9","30","40","80"
"halibty01","196","Tyrese Haliburton","PG","23","Indiana Pacers","500","1048","195","535","305","513","194","227","35","236","271","752","83","48","159","75","1389"
"hamptrj01","197","R.J. Hampton","PG","22","Miami Heat","4","14","1","8","3","6","1","2","2","4","6","8","0","0","3","8","10"
"hardati02","198","Tim Hardaway Jr.","SF","31","Dallas Mavericks","392","976","211","597","181","379","144","169","22","232","254","139","42","6","69","106","1139"
"hardeja01","199","James Harden","PG","34","Los Angeles Clippers","352","822","186","488","166","334","302","344","34","335","369","614","77","57","185","127","1192"
"hardyja02","200","Jaden Hardy","SG","21","Dallas Mavericks","195","479","81","224","114","255","59","76","20","111","131","109","22","4","62","80","530"
"harpero02","201","Ron Harper Jr.","PF","23","Toronto Raptors","0","0","0","0","0","0","0","0","0","0","0","1","0","0","0","2","0"
"harriga01","202","Gary Harris","SG","29","Orlando Magic","131","297","76","205","55","92","34","45","24","67","91","87","49","14","31","91","372"
"harrijo01","203","Joe Harris","SG","32","Detroit Pistons","14","39","10","30","4","9","1","2","3","10","13","10","3","2","4","19","39"
"harrike01","204","Kevon Harris","SG","26","Orlando Magic","2","3","0","0","2","3","0","0","0","2","2","1","0","0","1","3","4"
"harrito02","205","Tobias Harris","PF","31","Philadelphia 76ers","463","951","91","258","372","693","187","213","80","373","453","217","70","46","93","115","1204"
"harrish01","206","Shaquille Harrison","SG","30","Memphis Grizzlies","1","2","0","0","1","2","0","0","0","2","2","0","0","1","0","0","2"
"hartjo01","207","Josh Hart","SF","28","New York Knicks","295","679","80","258","215","421","91","115","128","547","675","331","75","23","118","171","761"
"harteis01","208","Isaiah Hartenstein","C","25","New York Knicks","235","365","1","3","234","362","111","157","244","382","626","188","87","85","93","210","582"
"hausesa01","209","Sam Hauser","SF","26","Boston Celtics","249","558","197","465","52","93","17","19","45","231","276","82","40","25","32","99","712"
"hawkijo01","210","Jordan Hawkins","SG","21","New Orleans Pelicans","174","456","109","298","65","158","67","80","29","119","148","70","19","7","40","72","524"
"hayesja02","211","Jaxson Hayes","C","23","Los Angeles Lakers","126","175","0","8","126","167","51","82","69","142","211","33","34","29","43","123","303"
"hayeski01","212","Killian Hayes","PG","22","Detroit Pistons","117","283","22","74","95","209","33","50","11","108","119","205","36","20","51","75","289"
"haywago01","213","Gordon Hayward","SF","33","Charlotte Hornets","139","297","22","61","117","236","62","81","25","92","117","116","28","12","51","46","362"
"haywago01","213","Gordon Hayward","SF","33","Oklahoma City Thunder","48","106","15","29","33","77","27","39","13","51","64","42","12","1","15","21","138"
"hendesc01","214","Scoot Henderson","PG","19","Portland Trail Blazers","307","797","87","268","220","529","167","204","53","141","194","336","48","13","212","195","868"
"hendrita01","215","Taylor Hendricks","PF","20","Utah Jazz","108","240","53","140","55","100","23","29","46","139","185","32","28","30","27","77","292"
"herroty01","216","Tyler Herro","SG","24","Miami Heat","324","735","132","333","192","402","95","111","19","203","222","188","30","3","93","63","875"
"hieldbu01","217","Buddy Hield","SF","31","Indiana Pacers","229","517","137","357","92","160","28","33","34","133","167","139","43","31","62","103","623"
"hieldbu01","217","Buddy Hield","SG","31","Philadelphia 76ers","142","333","82","211","60","122","24","26","27","75","102","97","27","11","41","66","390"
"highsha01","218","Haywood Highsmith","PF","27","Miami Heat","153","329","76","192","77","137","23","36","65","145","210","70","53","30","34","117","405"
"hintona01","219","Nate Hinton","SG","24","Houston Rockets","11","26","7","14","4","12","4","5","7","15","22","10","3","2","3","11","33"
"hodgedm01","220","DMoi Hodge","SG","25","Los Angeles Lakers","5","15","3","12","2","3","1","2","0","0","0","5","1","1","1","4","14"
"holidaa01","221","Aaron Holiday","PG","27","Houston Rockets","186","417","84","217","102","200","58","63","23","100","123","140","42","6","53","125","514"
"holidjr01","222","Jrue Holiday","PG","33","Boston Celtics","331","689","138","322","193","367","60","72","84","289","373","333","61","53","124","108","860"
"holidju01","223","Justin Holiday","SG","34","Denver Nuggets","88","194","55","136","33","58","3","4","9","62","71","67","36","9","14","69","234"
"holmeri01","224","Richaun Holmes","C","30","Dallas Mavericks","33","59","0","0","33","59","12","21","33","45","78","15","3","9","12","33","78"
"holmeri01","224","Richaun Holmes","PF","30","Washington Wizards","49","88","1","3","48","85","22","26","38","66","104","10","8","10","12","41","121"
"holmgch01","225","Chet Holmgren","C","21","Oklahoma City Thunder","505","953","129","349","376","604","218","275","129","519","648","200","53","190","131","197","1357"
"hoodsja01","226","Jalen Hood-Schifino","SG","20","Los Angeles Lakers","10","45","2","15","8","30","12","20","2","11","13","8","3","2","9","13","34"
"horfoal01","227","Al Horford","C","37","Boston Celtics","214","419","108","258","106","161","26","30","82","331","413","168","38","62","48","93","562"
"hortota01","228","Talen Horton-Tucker","PG","23","Utah Jazz","184","465","60","182","124","283","88","109","21","100","121","177","45","19","65","94","516"
"houseda01","229","Danuel House Jr.","SF","30","Philadelphia 76ers","47","105","15","50","32","55","35","46","16","42","58","28","15","5","19","45","144"
"houstca01","230","Caleb Houstan","SF","21","Orlando Magic","80","206","72","193","8","13","21","26","28","56","84","29","15","4","16","61","253"
"howarje01","231","Jett Howard","SF","20","Orlando Magic","10","30","7","25","3","5","2","4","1","6","7","6","2","2","3","4","29"
"huertke01","232","Kevin Huerter","SG","25","Sacramento Kings","248","560","123","341","125","219","36","47","38","186","224","166","45","23","53","135","655"
"huffja01","233","Jay Huff","C","25","Denver Nuggets","9","15","3","9","6","6","2","2","2","9","11","2","2","3","1","9","23"
"huntede01","234","DeAndre Hunter","SF","26","Atlanta Hawks","304","663","117","304","187","359","166","196","31","191","222","87","40","16","83","146","891"
"hurtma01","235","Matthew Hurt","PF","23","Memphis Grizzlies","12","34","5","20","7","14","3","3","9","7","16","4","3","3","2","8","32"
"hylanbo01","236","Bones Hyland","PG","23","Los Angeles Clippers","97","251","44","135","53","116","18","23","5","50","55","93","26","4","44","51","256"
"inglejo01","237","Joe Ingles","SF","36","Orlando Magic","99","227","70","161","29","66","28","34","18","124","142","203","43","5","67","88","296"
"ingrabr01","238","Brandon Ingram","SF","26","New Orleans Pelicans","500","1017","86","242","414","775","246","307","43","281","324","363","50","40","163","145","1332"
"irvinky01","239","Kyrie Irving","SG","31","Dallas Mavericks","562","1131","173","421","389","710","190","210","44","246","290","299","74","28","106","112","1487"
"isaacjo01","240","Jonathan Isaac","PF","26","Orlando Magic","146","286","42","112","104","174","59","82","73","187","260","30","43","70","27","64","393"
"iveyja01","241","Jaden Ivey","SG","21","Detroit Pistons","417","973","124","369","293","604","227","303","86","178","264","296","57","41","190","204","1185"
"jacksan01","242","Andre Jackson Jr.","SG","22","Milwaukee Bucks","50","100","17","46","33","54","8","11","43","70","113","50","16","6","28","92","125"
"jacksgg01","243","GG Jackson II","PF","19","Memphis Grizzlies","241","563","102","286","139","277","115","153","53","143","196","59","28","24","65","64","699"
"jacksis01","244","Isaiah Jackson","C","22","Indiana Pacers","155","233","0","4","155","229","73","102","94","144","238","50","34","61","39","137","383"
"jacksja02","245","Jaren Jackson Jr.","C","24","Memphis Grizzlies","516","1162","117","366","399","796","337","417","85","280","365","154","80","106","160","235","1486"
"jacksju01","246","Justin Jackson","SF","28","Minnesota Timberwolves","0","0","0","0","0","0","0","0","0","0","0","0","0","0","0","0","0"
"jacksqu01","247","Quenton Jackson","PG","25","Indiana Pacers","0","1","0","0","0","1","2","2","0","4","4","2","1","0","0","1","2"
"jacksre01","248","Reggie Jackson","PG","33","Denver Nuggets","326","756","102","284","224","472","79","98","33","122","155","308","44","13","106","149","833"
"jackstr02","249","Trayce Jackson-Davis","PF","23","Golden State Warriors","233","332","0","1","233","331","74","132","135","206","341","82","29","76","49","108","540"
"jamesle01","250","LeBron James","PF","39","Los Angeles Lakers","685","1269","149","363","536","906","303","404","61","457","518","589","89","38","245","78","1822"
"jaqueja01","251","Jaime Jaquez Jr.","SF","22","Miami Heat","341","697","65","202","276","495","142","175","82","203","285","195","77","20","110","167","889"
"jarrede01","252","DeJon Jarreau","SG","26","Memphis Grizzlies","17","50","4","13","13","37","5","11","8","36","44","26","6","2","9","14","43"
"jeffrda01","253","DaQuan Jeffries","SG","26","New York Knicks","6","17","2","10","4","7","0","2","0","5","5","5","0","1","3","2","14"
"jemistr01","254","Trey Jemison","C","24","Washington Wizards","0","0","0","0","0","0","0","0","0","1","1","0","0","0","1","0","0"
"jemistr01","254","Trey Jemison","C","24","Memphis Grizzlies","75","136","0","0","75","136","21","25","64","69","133","27","12","28","33","69","171"
"jeromty01","255","Ty Jerome","SG","26","Cleveland Cavaliers","2","4","0","1","2","3","0","0","1","0","1","3","0","0","1","2","4"
"joeis01","256","Isaiah Joe","SG","24","Oklahoma City Thunder","222","485","147","353","75","132","45","52","32","148","180","99","46","22","47","87","636"
"johnsca02","257","Cameron Johnson","PF","27","Brooklyn Nets","276","619","138","353","138","266","86","109","55","196","251","138","49","15","57","105","776"
"johnsja05","258","Jalen Johnson","SF","22","Atlanta Hawks","359","702","71","200","288","502","107","147","74","414","488","203","67","47","101","133","896"
"johnsja01","259","James Johnson","PF","36","Indiana Pacers","3","10","0","2","3","8","2","2","1","3","4","8","5","1","5","9","8"
"johnske04","260","Keldon Johnson","SF","24","San Antonio Spurs","391","862","127","367","264","495","175","221","95","282","377","195","51","20","100","149","1084"
"johnske07","261","Keon Johnson","SG","21","Brooklyn Nets","8","21","4","10","4","11","11","12","3","4","7","3","3","1","5","5","31"
"johnske08","262","Keyontae Johnson","SF","23","Oklahoma City Thunder","5","16","1","3","4","13","0","0","4","6","10","4","1","0","4","5","11"
"jokicni01","263","Nikola Jokic","C","28","Denver Nuggets","822","1411","83","231","739","1180","358","438","223","753","976","708","108","68","237","194","2085"
"jonesco02","264","Colby Jones","SG","21","Sacramento Kings","28","71","2","22","26","49","6","11","17","23","40","20","7","5","10","29","64"
"jonesda03","265","Damian Jones","C","28","Cleveland Cavaliers","43","72","3","14","40","58","18","21","20","42","62","15","7","13","13","27","107"
"jonesde02","266","Derrick Jones Jr.","SF","26","Dallas Mavericks","239","495","82","239","157","256","97","136","82","168","250","75","53","51","65","121","657"
"joneshe01","267","Herbert Jones","SF","25","New Orleans Pelicans","293","588","114","273","179","315","137","158","74","198","272","199","105","62","93","224","837"
"jonesma05","268","Mason Jones","SG","25","Sacramento Kings","2","8","2","7","0","1","1","2","1","4","5","5","1","0","2","3","7"
"jonestr01","269","Tre Jones","PG","24","San Antonio Spurs","303","600","64","191","239","409","101","118","58","231","289","478","78","9","116","92","771"
"jonesty01","270","Tyus Jones","PG","27","Washington Wizards","326","666","106","256","220","410","32","40","20","159","179","485","71","18","66","48","790"
"jordade01","271","DeAndre Jordan","C","35","Denver Nuggets","58","93","0","0","58","93","26","53","54","103","157","26","6","16","23","56","142"
"josepco01","272","Cory Joseph","PG","32","Golden State Warriors","23","64","13","42","10","22","4","7","6","24","30","42","4","3","12","25","63"
"jovicni01","273","Nikola Jovic","PF","20","Miami Heat","127","281","65","163","62","118","33","47","25","167","192","90","25","14","42","82","352"
"juzanjo01","274","Johnny Juzang","SG","22","Utah Jazz","51","110","32","77","19","33","10","14","7","29","36","23","4","2","13","29","144"
"kennalu01","275","Luke Kennard","SG","27","Memphis Grizzlies","141","315","107","238","34","77","40","45","11","102","113","136","20","2","54","39","429"
"kesslwa01","276","Walker Kessler","C","22","Utah Jazz","229","350","4","19","225","331","56","93","165","316","481","60","30","154","66","132","518"
"keybr01","277","Braxton Key","SF","26","Denver Nuggets","7","17","2","5","5","12","6","8","3","15","18","9","2","1","1","5","22"
"kispeco01","278","Corey Kispert","SF","24","Washington Wizards","386","794","184","480","202","314","114","157","30","195","225","156","41","16","98","141","1070"
"klebima01","279","Maxi Kleber","C","32","Dallas Mavericks","63","146","32","92","31","54","33","47","30","113","143","68","17","30","28","79","191"
"knoxke01","280","Kevin Knox","SF","24","Detroit Pistons","86","186","31","94","55","92","20","22","18","57","75","23","13","7","22","50","223"
"konchjo01","281","John Konchar","SF","27","Memphis Grizzlies","88","208","38","120","50","88","21","25","72","185","257","110","51","51","46","76","235"
"korkmfu01","282","Furkan Korkmaz","SG","26","Philadelphia 76ers","30","76","14","40","16","36","14","20","4","26","30","25","14","3","10","17","88"
"kornelu01","283","Luke Kornet","C","28","Boston Celtics","142","203","1","1","141","202","49","54","118","143","261","67","23","61","21","77","334"
"krejcvi01","284","Vit Krejci","PG","23","Atlanta Hawks","51","104","28","68","23","36","5","6","11","41","52","50","13","6","20","48","135"
"kuminjo01","285","Jonathan Kuminga","PF","21","Golden State Warriors","456","862","53","165","403","697","223","299","92","263","355","163","55","36","122","169","1188"
"kuzmaky01","286","Kyle Kuzma","PF","28","Washington Wizards","608","1313","151","450","457","863","186","240","62","402","464","296","37","49","192","153","1553"
"landajo01","287","Jock Landale","C","28","Houston Rockets","106","206","10","40","96","166","52","65","88","84","172","65","20","33","31","74","274"
"laravja01","288","Jake LaRavia","PF","22","Memphis Grizzlies","118","303","53","156","65","147","90","109","51","77","128","58","29","12","45","69","379"
"lavinza01","289","Zach LaVine","SG","28","Chicago Bulls","170","376","59","169","111","207","88","103","8","121","129","98","21","8","52","57","487"
"lawsoaj01","290","A.J. Lawson","SG","23","Dallas Mavericks","54","121","13","50","41","71","15","23","14","36","50","20","10","3","14","22","136"
"leesa01","291","Saben Lee","PG","24","Phoenix Suns","20","55","2","16","18","39","29","39","9","22","31","30","7","3","8","13","71"
"lenal01","292","Alex Len","C","30","Sacramento Kings","50","81","0","3","50","78","20","34","46","82","128","50","11","33","27","66","120"
"leonaka01","293","Kawhi Leonard","SF","32","Los Angeles Clippers","610","1162","140","336","470","826","253","286","84","332","416","244","111","59","119","97","1613"
"leverca01","294","Caris LeVert","SG","29","Cleveland Cavaliers","345","820","108","332","237","488","154","201","39","241","280","346","76","34","117","121","952"
"lewiski01","295","Kira Lewis Jr.","PG","22","New Orleans Pelicans","16","52","2","20","14","32","10","11","4","10","14","18","5","1","8","8","44"
"lewiski01","295","Kira Lewis Jr.","PG","22","Toronto Raptors","0","0","0","0","0","0","0","0","0","0","0","0","0","0","0","1","0"
"lewiski01","295","Kira Lewis Jr.","PG","22","Utah Jazz","18","40","2","13","16","27","7","9","5","7","12","19","4","1","6","4","45"
"lewisma05","296","Maxwell Lewis","SF","21","Los Angeles Lakers","4","21","1","9","3","12","2","3","2","2","4","6","2","1","10","5","11"
"liddeej01","297","E.J. Liddell","PF","23","New Orleans Pelicans","1","6","0","5","1","1","2","2","0","5","5","1","2","2","2","2","4"
"lillada01","298","Damian Lillard","PG","33","Milwaukee Bucks","541","1277","220","622","321","655","473","514","36","284","320","508","72","18","193","134","1775"
"littlna01","299","Nassir Little","SF","23","Phoenix Suns","57","124","21","70","36","54","17","20","14","61","75","21","10","10","14","39","152"
"livelde01","300","Dereck Lively II","C","19","Dallas Mavericks","221","296","0","2","221","294","41","81","135","243","378","60","36","77","50","144","483"
"liveris01","301","Isaiah Livers","PF","25","Detroit Pistons","40","116","22","77","18","39","12","18","15","33","48","25","13","5","16","43","114"
"livinch01","302","Chris Livingston","SF","20","Milwaukee Bucks","11","22","1","5","10","17","3","4","3","18","21","5","2","0","5","15","26"
"loftoke01","303","Kenneth Lofton Jr.","PF","21","Memphis Grizzlies","14","37","3","10","11","27","8","15","2","13","15","14","3","3","6","15","39"
"loftoke01","303","Kenneth Lofton Jr.","PF","21","Philadelphia 76ers","1","6","0","2","1","4","0","0","0","3","3","0","0","0","2","0","2"
"loftoke01","303","Kenneth Lofton Jr.","PF","21","Utah Jazz","21","35","4","12","17","23","9","11","10","10","20","19","3","2","6","9","55"
"looneke01","304","Kevon Looney","C","27","Golden State Warriors","139","233","0","1","139","232","56","83","143","276","419","133","28","29","50","155","334"
"lopezbr01","305","Brook Lopez","C","35","Milwaukee Bucks","366","755","148","404","218","351","110","134","117","292","409","127","43","189","79","191","990"
"lopezro01","306","Robin Lopez","C","35","Milwaukee Bucks","7","19","2","8","5","11","2","2","3","2","5","4","1","3","2","7","18"
"loveke01","307","Kevin Love","PF","35","Miami Heat","158","359","84","244","74","115","85","108","59","279","338","115","18","10","48","97","485"
"lowryky01","308","Kyle Lowry","PG","37","Miami Heat","103","242","62","161","41","81","35","42","25","104","129","147","39","15","53","94","303"
"lowryky01","308","Kyle Lowry","PG","37","Philadelphia 76ers","60","135","36","89","24","46","28","33","9","56","65","106","20","6","32","52","184"
"lundyse01","309","Seth Lundy","SF","23","Atlanta Hawks","4","17","3","13","1","4","3","4","1","6","7","0","0","0","1","6","14"
"lylestr01","310","Trey Lyles","PF","28","Sacramento Kings","143","321","84","219","59","102","49","70","61","196","257","72","17","19","38","86","419"
"maledth01","311","Théo Maledon","PG","22","Charlotte Hornets","19","66","5","30","14","36","11","12","4","19","23","28","7","0","15","18","54"
"maledth01","311","Théo Maledon","PG","22","Phoenix Suns","1","4","0","0","1","4","3","3","0","1","1","0","0","0","3","3","5"
"mamuksa01","312","Sandro Mamukelashvili","C","24","San Antonio Spurs","73","155","19","64","54","91","25","34","45","102","147","49","7","12","19","35","190"
"mannte01","313","Terance Mann","SG","27","Los Angeles Clippers","254","493","71","204","183","289","79","95","87","167","254","119","43","15","48","145","658"
"manntr01","314","Tre Mann","PG","22","Oklahoma City Thunder","20","40","8","19","12","21","1","1","4","20","24","20","3","0","9","3","49"
"manntr01","314","Tre Mann","PG","22","Charlotte Hornets","125","276","39","107","86","169","44","58","16","109","125","145","48","3","56","45","333"
"marjabo01","315","Boban Marjanovic","C","35","Houston Rockets","18","34","0","2","18","32","9","14","7","25","32","6","1","2","5","5","45"
"markkla01","316","Lauri Markkanen","PF","26","Utah Jazz","427","890","175","439","252","451","249","277","122","327","449","110","50","26","77","100","1278"
"marshna01","317","Naji Marshall","SF","26","New Orleans Pelicans","170","367","58","150","112","217","68","86","53","187","240","128","49","12","65","91","466"
"martica02","318","Caleb Martin","SF","28","Miami Heat","241","559","81","232","160","327","77","99","74","207","281","143","47","29","77","126","640"
"martico01","319","Cody Martin","SF","28","Charlotte Hornets","82","215","27","86","55","129","20","33","19","90","109","104","32","18","44","48","211"
"martike04","320","KJ Martin","SF","23","Los Angeles Clippers","4","10","1","5","3","5","1","2","1","2","3","1","2","1","2","3","10"
"martike04","320","KJ Martin","SF","23","Philadelphia 76ers","93","171","7","23","86","148","21","39","40","88","128","50","20","11","30","97","214"
"mathega01","321","Garrison Mathews","SG","27","Atlanta Hawks","103","226","85","193","18","33","34","42","17","75","92","37","20","8","19","115","325"
"mathube01","322","Bennedict Mathurin","SF","21","Indiana Pacers","296","663","80","214","216","449","184","224","60","174","234","119","35","14","97","117","856"
"matthwe02","323","Wesley Matthews","SG","37","Atlanta Hawks","34","97","24","69","10","28","18","24","9","44","53","23","16","11","8","43","110"
"maxeyty01","324","Tyrese Maxey","PG","23","Philadelphia 76ers","638","1419","212","569","426","850","328","378","36","222","258","433","69","33","116","151","1816"
"mayssk01","325","Skylar Mays","PG","26","Portland Trail Blazers","53","138","14","49","39","89","13","17","9","28","37","75","14","3","18","20","133"
"mayssk01","325","Skylar Mays","SG","26","Los Angeles Lakers","10","21","2","5","8","16","0","0","1","5","6","10","7","1","2","6","22"
"mcbrimi01","326","Miles McBride","PG","23","New York Knicks","205","454","109","266","96","188","43","50","31","69","100","114","50","7","30","108","562"
"mccolcj01","327","CJ McCollum","PG","32","New Orleans Pelicans","484","1055","239","557","245","498","115","139","39","247","286","305","62","41","110","126","1322"
"mccontj01","328","T.J. McConnell","PG","31","Indiana Pacers","330","593","18","44","312","549","49","62","36","155","191","390","72","8","108","79","727"
"mcdanja02","329","Jaden McDaniels","SF","23","Minnesota Timberwolves","307","628","86","255","221","373","57","79","56","168","224","101","63","42","87","219","757"
"mcdanja01","330","Jalen McDaniels","SF","26","Toronto Raptors","65","189","12","71","53","118","27","37","18","61","79","37","19","6","30","52","169"
"mcderdo01","331","Doug McDermott","SF","32","San Antonio Spurs","95","215","76","173","19","42","10","17","8","40","48","57","11","2","24","48","276"
"mcderdo01","331","Doug McDermott","SF","32","Indiana Pacers","28","69","18","56","10","13","1","2","2","9","11","13","5","0","4","16","75"
"mcgeeja01","332","JaVale McGee","C","36","Sacramento Kings","79","132","1","7","78","125","26","45","42","84","126","17","14","20","34","46","185"
"mcgowbr01","333","Bryce McGowens","SG","21","Charlotte Hornets","101","230","34","102","67","128","66","85","17","85","102","51","21","10","30","74","302"
"mclaujo01","334","Jordan McLaughlin","PG","27","Minnesota Timberwolves","70","145","42","89","28","56","13","18","18","54","72","110","35","7","19","31","195"
"meltode01","335","DeAnthony Melton","SG","25","Philadelphia 76ers","139","360","77","214","62","146","66","79","28","113","141","114","60","16","39","84","421"
"mensana01","336","Nathan Mensah","C","25","Charlotte Hornets","12","28","0","0","12","28","9","12","29","36","65","9","6","14","14","64","33"
"merrisa01","337","Sam Merrill","SG","27","Cleveland Cavaliers","158","393","143","354","15","39","26","28","22","98","120","108","19","4","19","72","485"
"metuch01","338","Chimezie Metu","C","26","Phoenix Suns","66","130","15","51","51","79","38","43","24","86","110","19","19","9","27","39","185"
"metuch01","338","Chimezie Metu","C","26","Detroit Pistons","57","114","13","43","44","71","20","21","17","67","84","27","24","7","25","32","147"
"micicva01","339","Vasilije Micić","PG","30","Oklahoma City Thunder","37","91","11","45","26","46","14","19","1","23","24","76","9","3","29","22","99"
"micicva01","339","Vasilije Micić","PG","30","Charlotte Hornets","122","279","32","109","90","170","47","56","13","51","64","186","22","4","70","46","323"
"middlkh01","340","Khris Middleton","SF","32","Milwaukee Bucks","317","643","94","247","223","396","100","120","40","217","257","292","51","15","127","141","828"
"millebr02","341","Brandon Miller","SF","21","Charlotte Hornets","476","1083","184","493","292","590","143","173","60","255","315","175","66","42","132","184","1279"
"millejo02","342","Jordan Miller","SF","24","Los Angeles Clippers","5","9","1","2","4","7","2","2","3","2","5","0","0","0","1","2","13"
"millele01","343","Leonard Miller","SF","20","Minnesota Timberwolves","13","20","2","5","11","15","1","2","5","15","20","8","2","1","1","5","29"
"whiteda01","344","Dariq Whitehead","SF","19","Brooklyn Nets","1","5","0","3","1","2","1","2","0","4","4","3","0","1","0","0","3"
"millspa02","345","Patty Mills","PG","35","Atlanta Hawks","19","51","13","34","6","17","0","0","5","15","20","14","9","1","8","17","51"
"millspa02","345","Patty Mills","PG","35","Miami Heat","27","80","11","53","16","27","11","11","4","11","15","20","11","0","8","15","76"
"miltosh01","346","Shake Milton","SG","27","Minnesota Timberwolves","64","160","14","53","50","107","36","44","7","44","51","50","16","5","28","44","178"
"miltosh01","346","Shake Milton","SG","27","Detroit Pistons","11","26","3","9","8","17","2","3","7","11","18","6","2","1","3","3","27"
"miltosh01","346","Shake Milton","SG","27","New York Knicks","4","9","1","2","3","7","2","2","0","6","6","4","1","0","0","7","11"
"minayju01","347","Justin Minaya","SF","24","Portland Trail Blazers","22","74","12","49","10","25","5","9","30","26","56","21","9","10","9","35","61"
"minotjo01","348","Josh Minott","SF","21","Minnesota Timberwolves","17","36","4","10","13","26","12","14","4","13","17","8","5","5","2","10","50"
"mitchda01","349","Davion Mitchell","PG","25","Sacramento Kings","146","323","57","158","89","165","30","42","19","76","95","134","17","3","43","85","379"
"mitchdo01","350","Donovan Mitchell","SG","27","Cleveland Cavaliers","503","1089","182","494","321","595","275","318","46","234","280","333","101","30","154","118","1463"
"mobleev01","351","Evan Mobley","PF","22","Cleveland Cavaliers","320","552","22","59","298","493","123","171","111","357","468","160","45","72","90","134","785"
"mobleis01","352","Isaiah Mobley","PF","24","Cleveland Cavaliers","10","24","3","10","7","14","0","1","3","7","10","6","2","0","2","6","23"
"monkma01","353","Malik Monk","SG","25","Sacramento Kings","396","893","148","423","248","470","170","205","28","184","212","370","45","39","150","156","1110"
"moodymo01","354","Moses Moody","SG","21","Golden State Warriors","194","420","72","200","122","220","73","93","65","131","196","57","42","24","44","90","533"
"moonxa01","355","Xavier Moon","SG","29","Los Angeles Clippers","15","46","2","17","13","29","1","2","8","10","18","21","3","3","5","8","33"
"mooreta02","356","Taze Moore","SG","25","Portland Trail Blazers","8","19","1","7","7","12","1","2","4","4","8","5","2","0","3","4","18"
"moorewe01","357","Wendell Moore Jr.","SG","22","Minnesota Timberwolves","9","18","0","6","9","12","0","0","0","12","12","6","5","1","4","5","18"
"moranja01","358","Ja Morant","PG","24","Memphis Grizzlies","80","170","14","51","66","119","52","64","6","44","50","73","7","5","27","19","226"
"morrima03","359","Marcus Morris","PF","34","Philadelphia 76ers","90","205","36","90","54","115","31","36","18","91","109","26","13","11","19","61","247"
"morrima03","359","Marcus Morris","PF","34","Cleveland Cavaliers","26","59","12","29","14","30","5","8","5","20","25","10","2","2","11","13","69"
"morrima02","360","Markieff Morris","PF","34","Dallas Mavericks","23","68","15","42","8","26","5","6","4","35","39","16","5","3","12","12","66"
"morrimo01","361","Monte Morris","PG","28","Detroit Pistons","12","33","2","11","10","22","1","2","2","10","12","8","1","1","2","1","27"
"morrimo01","361","Monte Morris","PG","28","Minnesota Timberwolves","50","120","25","59","25","61","12","17","5","40","45","61","18","8","5","13","137"
"murphtr02","362","Trey Murphy III","SF","23","New Orleans Pelicans","275","621","169","445","106","176","123","151","42","238","280","124","51","28","34","70","842"
"murrade01","363","Dejounte Murray","SG","27","Atlanta Hawks","672","1463","201","554","471","909","208","262","62","354","416","502","111","24","201","138","1753"
"murraja01","364","Jamal Murray","PG","26","Denver Nuggets","474","986","145","341","329","645","157","184","42","200","242","384","57","39","125","104","1250"
"murrake02","365","Keegan Murray","SF","23","Sacramento Kings","443","975","183","511","260","464","103","124","106","314","420","129","79","59","64","205","1172"
"murrakr01","366","Kris Murray","SF","23","Portland Trail Blazers","145","366","49","183","96","183","37","56","85","139","224","80","53","21","55","92","376"
"muscami01","367","Mike Muscala","C","32","Washington Wizards","33","90","14","51","19","39","15","20","22","53","75","22","5","7","16","31","95"
"muscami01","367","Mike Muscala","C","32","Detroit Pistons","15","44","13","34","2","10","2","4","10","19","29","10","3","5","2","13","45"
"muscami01","367","Mike Muscala","C","32","Oklahoma City Thunder","8","22","1","11","7","11","0","1","7","14","21","4","1","1","4","8","17"
"mykhasv01","368","Svi Mykhailiuk","SF","26","Boston Celtics","57","137","42","108","15","29","6","9","11","40","51","35","11","1","12","19","162"
"nancela02","369","Larry Nance Jr.","C","31","New Orleans Pelicans","138","241","27","65","111","176","47","61","94","213","307","113","61","19","49","98","350"
"nancepe01","370","Pete Nance","PF","23","Cleveland Cavaliers","1","6","1","1","0","5","0","2","0","3","3","0","1","0","1","2","3"
"nembhan01","371","Andrew Nembhard","PG","24","Indiana Pacers","260","522","61","171","199","351","45","56","36","105","141","280","63","6","101","143","626"
"nesmiaa01","372","Aaron Nesmith","SF","24","Indiana Pacers","315","635","140","334","175","301","107","137","63","212","275","108","65","49","64","241","877"
"niangge01","373","Georges Niang","PF","30","Cleveland Cavaliers","284","632","149","396","135","236","51","60","22","256","278","98","30","18","72","192","768"
"nixda01","374","Daishen Nix","PG","21","Minnesota Timberwolves","9","24","6","17","3","7","3","6","1","2","3","6","5","0","5","2","27"
"nnajize01","375","Zeke Nnaji","PF","23","Denver Nuggets","69","149","6","23","63","126","42","62","61","65","126","32","15","38","27","81","186"
"nowelja01","376","Jaylen Nowell","SG","24","Memphis Grizzlies","22","55","4","23","18","32","3","3","3","11","14","16","3","0","5","13","51"
"nowelja01","376","Jaylen Nowell","SG","24","Detroit Pistons","12","23","2","6","10","17","4","6","3","7","10","3","1","2","2","2","30"
"nowelma01","377","Markquis Nowell","SG","24","Toronto Raptors","0","1","0","0","0","1","2","2","2","0","2","2","1","0","0","0","2"
"ntilila01","378","Frank Ntilikina","PG","25","Charlotte Hornets","1","9","1","8","0","1","2","2","1","5","6","4","0","0","1","4","5"
"nurkiju01","379","Jusuf Nurkic","C","29","Phoenix Suns","320","627","22","90","298","537","167","261","224","613","837","301","81","80","175","254","829"
"nworajo01","380","Jordan Nwora","SF","25","Indiana Pacers","37","82","11","36","26","46","9","11","8","25","33","18","6","1","12","19","94"
"nworajo01","380","Jordan Nwora","SF","25","Toronto Raptors","101","217","33","95","68","122","35","42","20","96","116","44","20","12","41","29","270"
"onealro01","381","Royce ONeale","SF","30","Brooklyn Nets","126","325","97","265","29","60","15","22","38","183","221","137","32","29","51","120","364"
"onealro01","381","Royce ONeale","SF","30","Phoenix Suns","88","214","59","157","29","57","9","13","22","134","156","82","27","15","22","54","244"
"okekech01","382","Chuma Okeke","SF","25","Orlando Magic","40","112","23","82","17","30","4","7","18","62","80","20","9","7","16","19","107"
"okogijo01","383","Josh Okogie","SG","25","Phoenix Suns","86","206","29","94","57","112","76","102","74","80","154","64","48","24","36","68","277"
"okongon01","384","Onyeka Okongwu","C","23","Atlanta Hawks","223","365","23","69","200","296","92","116","145","231","376","74","26","60","45","162","561"
"okorois01","385","Isaac Okoro","SF","23","Cleveland Cavaliers","235","480","84","215","151","265","93","137","67","139","206","132","57","34","54","140","647"
"olynyke01","386","Kelly Olynyk","C","32","Utah Jazz","145","258","36","84","109","174","80","95","63","191","254","219","37","12","81","132","406"
"olynyke01","386","Kelly Olynyk","C","32","Toronto Raptors","131","239","24","71","107","168","70","85","45","112","157","128","37","18","71","98","356"
"omorueu01","387","Eugene Omoruyi","SF","26","Washington Wizards","81","167","13","46","68","121","32","49","35","50","85","35","27","5","21","62","207"
"osmande01","388","Cedi Osman","SF","28","San Antonio Spurs","184","384","86","221","98","163","35","52","25","155","180","119","36","11","47","107","489"
"oubreke01","389","Kelly Oubre Jr.","SF","28","Philadelphia 76ers","387","878","101","325","286","553","174","232","94","247","341","101","77","47","87","194","1049"
"paulch01","390","Chris Paul","PG","38","Golden State Warriors","206","467","78","210","128","257","43","52","18","207","225","393","70","6","76","108","533"
"payneca01","391","Cameron Payne","PG","29","Milwaukee Bucks","101","222","52","131","49","91","37","44","5","57","62","109","22","3","31","73","291"
"payneca01","391","Cameron Payne","PG","29","Philadelphia 76ers","107","259","52","136","55","123","21","23","16","39","55","96","20","8","35","53","287"
"paytoga02","392","Gary Payton II","SG","31","Golden State Warriors","103","183","20","55","83","128","14","23","46","67","113","48","39","18","27","77","240"
"pereima01","393","Mãozinha Pereira","SF","23","Memphis Grizzlies","18","35","5","13","13","22","7","10","11","26","37","2","6","4","5","10","48"
"peterdr01","394","Drew Peterson","PF","24","Boston Celtics","4","6","3","5","1","1","0","0","0","1","1","1","2","0","1","1","11"
"petrufi01","395","Filip Petrušev","C","23","Philadelphia 76ers","0","0","0","0","0","0","0","0","0","1","1","0","0","0","0","0","0"
"petrufi01","395","Filip Petrušev","C","23","Sacramento Kings","1","2","0","0","1","2","1","2","0","0","0","0","0","0","0","1","3"
"phillju01","396","Julian Phillips","SF","20","Chicago Bulls","32","77","12","38","20","39","13","19","12","24","36","13","7","7","10","40","89"
"pickeja02","397","Jalen Pickett","SG","24","Denver Nuggets","15","35","9","25","6","10","3","4","1","13","14","21","4","0","9","13","42"
"pippesc02","398","Scotty Pippen Jr.","PG","23","Memphis Grizzlies","100","203","30","72","70","131","41","55","22","45","67","98","36","10","56","60","271"
"plumlma01","399","Mason Plumlee","C","33","Los Angeles Clippers","87","153","0","6","87","147","70","99","60","174","234","55","14","17","36","68","244"
"podzibr01","400","Brandin Podziemski","SG","20","Golden State Warriors","271","597","90","234","181","363","50","79","118","309","427","273","61","14","88","122","682"
"poeltja01","401","Jakob Poeltl","C","28","Toronto Raptors","248","378","0","0","248","378","59","107","146","283","429","127","35","76","77","149","555"
"pokusal01","402","Aleksej Pokusevski","PF","22","Oklahoma City Thunder","4","16","2","11","2","5","2","4","2","8","10","5","1","1","3","5","12"
"pokusal01","402","Aleksej Pokusevski","PF","22","Charlotte Hornets","45","105","16","44","29","61","28","37","15","64","79","30","14","12","16","17","134"
"poolejo01","403","Jordan Poole","SG","24","Washington Wizards","490","1186","184","564","306","622","192","219","32","180","212","343","86","25","188","244","1356"
"portecr01","404","Craig Porter Jr.","PG","23","Cleveland Cavaliers","116","228","12","34","104","194","41","56","21","88","109","118","21","15","45","40","285"
"portejo01","405","Jontay Porter","PF","24","Toronto Raptors","40","104","20","60","20","44","15","18","26","56","82","60","20","20","21","35","115"
"portemi01","406","Michael Porter Jr.","SF","25","Denver Nuggets","522","1079","220","554","302","525","92","110","106","459","565","122","42","53","92","148","1356"
"porteot01","407","Otto Porter Jr.","SF","30","Toronto Raptors","14","33","8","23","6","10","3","3","6","23","29","8","5","5","2","19","39"
"portibo01","408","Bobby Portis","PF","28","Milwaukee Bucks","466","918","100","246","366","672","98","124","142","465","607","104","68","34","91","189","1130"
"porzikr01","409","Kristaps Porzingis","C","28","Boston Celtics","388","752","110","293","278","459","259","302","97","312","409","115","42","111","89","156","1145"
"pottemi01","410","Micah Potter","PF","25","Utah Jazz","19","40","9","21","10","19","6","8","10","33","43","6","4","6","5","14","53"
"poweldw01","411","Dwight Powell","C","32","Dallas Mavericks","72","106","1","3","71","103","63","89","97","117","214","84","26","20","32","113","208"
"powelno01","412","Norman Powell","SG","30","Los Angeles Clippers","373","768","167","384","206","384","143","172","16","179","195","82","43","22","66","137","1056"
"prestja01","413","Jason Preston","PG","24","Utah Jazz","6","19","0","3","6","16","0","0","6","11","17","16","2","1","2","3","12"
"primojo01","414","Joshua Primo","SG","21","Los Angeles Clippers","1","3","0","1","1","2","0","0","1","0","1","0","0","1","4","0","2"
"princta02","415","Taurean Prince","PF","29","Los Angeles Lakers","253","572","141","356","112","216","50","68","21","209","230","119","58","35","73","146","697"
"pritcpa01","416","Payton Pritchard","PG","26","Boston Celtics","297","635","147","382","150","253","46","56","70","195","265","281","39","6","61","106","787"
"prospol01","417","Olivier-Maxence Prosper","PF","21","Dallas Mavericks","40","104","13","45","27","59","28","41","25","54","79","22","7","4","8","20","121"
"queentr01","418","Trevelin Queen","SG","26","Orlando Magic","14","38","3","17","11","21","9","12","3","17","20","18","7","5","7","15","40"
"quetane01","419","Neemias Queta","C","24","Boston Celtics","67","104","0","0","67","104","20","28","53","69","122","20","13","21","13","50","154"
"quickim01","420","Immanuel Quickley","SG","24","New York Knicks","152","335","64","162","88","173","82","94","5","72","77","74","16","3","31","44","450"
"quickim01","420","Immanuel Quickley","PG","24","Toronto Raptors","236","559","107","271","129","288","127","151","12","170","182","257","34","7","70","75","706"
"quinole01","421","Lester Quinones","SG","23","Golden State Warriors","56","141","32","88","24","53","20","29","21","51","72","36","6","2","17","44","164"
"ramseja01","422","Jahmius Ramsey","SG","22","Toronto Raptors","18","41","6","22","12","19","5","6","4","18","22","8","7","0","7","10","47"
"randlju01","423","Julius Randle","PF","29","New York Knicks","395","836","76","244","319","592","236","302","99","324","423","229","25","12","159","125","1102"
"reathdu01","424","Duop Reath","C","27","Portland Trail Blazers","230","499","88","245","142","254","69","93","93","157","250","67","33","38","52","161","617"
"reaveau01","425","Austin Reaves","SG","25","Los Angeles Lakers","457","940","154","420","303","520","232","272","57","295","352","450","66","25","174","153","1300"
"reddica01","426","Cam Reddish","SF","24","Los Angeles Lakers","91","234","37","110","54","124","41","54","27","72","99","48","47","14","31","64","260"
"reedpa01","427","Paul Reed","C","24","Philadelphia 76ers","259","480","21","57","238","423","61","85","193","295","488","109","67","84","67","198","600"
"reidna01","428","Naz Reid","C","24","Minnesota Timberwolves","406","851","169","408","237","443","109","148","73","350","423","106","63","73","111","172","1090"
"rhodeja01","429","Jared Rhoden","SG","24","Detroit Pistons","33","66","12","31","21","35","5","8","3","30","33","14","3","13","7","28","83"
"richani01","430","Nick Richards","C","26","Charlotte Hornets","260","376","0","1","260","375","132","179","172","367","539","54","26","74","73","176","652"
"richajo01","431","Josh Richardson","SG","30","Miami Heat","154","347","66","190","88","157","51","54","18","103","121","105","24","14","36","76","425"
"robindu01","432","Duncan Robinson","SF","29","Miami Heat","304","675","187","473","117","202","80","90","15","158","173","192","46","16","95","163","875"
"robinje01","433","Jerome Robinson","SG","26","Golden State Warriors","11","33","2","17","9","16","7","11","1","5","6","5","1","3","2","5","31"
"robinmi01","434","Mitchell Robinson","C","25","New York Knicks","73","127","0","0","73","127","27","66","142","121","263","18","37","35","25","55","173"
"robinor01","435","Orlando Robinson","C","23","Miami Heat","36","72","8","15","28","57","19","25","28","56","84","34","7","8","18","35","99"
"robinje02","436","Jeremiah Robinson-Earl","PF","23","New Orleans Pelicans","45","95","13","39","32","56","12","16","23","53","76","21","10","4","16","24","115"
"roddyda01","437","David Roddy","PF","22","Memphis Grizzlies","155","386","47","156","108","230","46","67","51","149","200","76","25","11","54","68","403"
"roddyda01","437","David Roddy","PF","22","Phoenix Suns","10","23","1","8","9","15","1","1","2","9","11","4","2","0","3","4","22"
"rolliry01","438","Ryan Rollins","PG","21","Washington Wizards","13","25","2","3","11","22","13","17","2","9","11","11","8","3","7","7","41"
"rolliry01","438","Ryan Rollins","PG","21","Milwaukee Bucks","1","2","1","1","0","1","0","0","0","2","2","3","2","0","1","1","3"
"rosede01","439","Derrick Rose","PG","35","Memphis Grizzlies","76","165","15","41","61","124","24","27","7","38","45","78","8","2","31","21","191"
"roziete01","440","Terry Rozier","SG","29","Charlotte Hornets","252","549","83","232","169","317","109","129","17","100","117","198","32","12","65","52","696"
"roziete01","440","Terry Rozier","PG","29","Miami Heat","190","449","66","178","124","271","63","69","18","112","130","144","31","9","41","49","509"
"ruperra01","441","Rayan Rupert","SG","19","Portland Trail Blazers","54","161","28","78","26","83","19","25","24","68","92","62","12","3","31","56","155"
"russeda01","442","DAngelo Russell","PG","27","Los Angeles Lakers","492","1080","226","545","266","535","159","192","28","208","236","482","69","36","156","156","1369"
"ryanma01","443","Matt Ryan","SF","26","New Orleans Pelicans","49","113","41","91","8","22","13","14","6","34","40","18","6","1","19","32","152"
"sabondo01","444","Domantas Sabonis","C","27","Sacramento Kings","634","1068","33","87","601","981","292","415","294","826","1120","673","74","48","272","250","1593"
"samanlu01","445","Luka Samanic","PF","24","Utah Jazz","60","158","13","64","47","94","44","56","22","80","102","19","5","7","28","32","177"
"samueje01","446","Jermaine Samuels","SF","25","Houston Rockets","9","14","0","2","9","12","2","2","3","10","13","3","1","2","0","5","20"
"sanogad01","447","Adama Sanogo","PF","21","Chicago Bulls","14","27","0","0","14","27","8","12","19","17","36","0","1","0","5","5","36"
"santogu01","448","Gui Santos","PF","21","Golden State Warriors","28","55","10","27","18","28","16","17","17","32","49","14","4","2","7","23","82"
"saricda01","449","Dario Saric","C","29","Golden State Warriors","181","388","74","197","107","191","79","93","73","210","283","144","31","10","78","112","515"
"sarrol01","450","Olivier Sarr","C","24","Oklahoma City Thunder","11","19","2","6","9","13","10","15","10","26","36","2","0","7","3","18","34"
"sassema01","451","Marcus Sasser","PG","23","Detroit Pistons","219","512","90","240","129","272","58","66","11","114","125","236","44","12","90","103","586"
"schofad01","452","Admiral Schofield","PF","26","Orlando Magic","10","26","6","16","4","10","0","2","3","14","17","7","1","0","5","9","26"
"schrode01","453","Dennis Schröder","PG","30","Toronto Raptors","247","559","77","220","170","339","127","149","22","118","140","313","46","8","83","105","698"
"schrode01","453","Dennis Schröder","PG","30","Brooklyn Nets","156","368","61","148","95","220","51","64","17","85","102","175","17","9","70","59","424"
"seabrde01","454","Dereon Seabron","SG","23","New Orleans Pelicans","4","13","1","2","3","11","5","6","1","6","7","5","2","1","0","4","14"
"sengual01","455","Alperen Sengun","C","21","Houston Rockets","527","982","33","111","494","871","244","352","183","406","589","312","76","46","162","211","1331"
"sensabr01","456","Brice Sensabaugh","SF","20","Utah Jazz","85","218","34","115","51","103","37","41","16","86","102","55","13","6","47","43","241"
"sextoco01","457","Collin Sexton","SG","25","Utah Jazz","506","1038","128","325","378","713","318","370","71","134","205","383","62","18","165","154","1458"
"shamela01","458","Landry Shamet","SG","26","Washington Wizards","118","274","53","157","65","117","38","46","16","46","62","54","25","10","30","76","327"
"sharpda01","459","DayRon Sharpe","C","22","Brooklyn Nets","168","294","4","15","164","279","75","123","161","228","389","85","24","44","70","131","415"
"sharpsh01","460","Shaedon Sharpe","SG","20","Portland Trail Blazers","176","434","60","180","116","254","98","119","42","118","160","94","28","12","72","88","510"
"sheppbe01","461","Ben Sheppard","SG","22","Indiana Pacers","90","229","49","156","41","73","23","26","15","74","89","53","33","2","15","88","252"
"siakapa01","462","Pascal Siakam","PF","29","Toronto Raptors","325","623","46","145","279","478","169","223","54","192","246","190","32","10","83","87","865"
"siakapa01","462","Pascal Siakam","PF","29","Indiana Pacers","356","648","39","101","317","547","121","173","85","234","319","152","31","15","58","106","872"
"simmobe01","463","Ben Simmons","PG","27","Brooklyn Nets","43","74","0","0","43","74","6","15","31","88","119","86","12","9","27","36","92"
"simmoko01","464","Kobi Simmons","PG","26","Toronto Raptors","9","21","2","8","7","13","0","0","1","6","7","12","6","2","1","5","20"
"simonan01","465","Anfernee Simons","SG","24","Portland Trail Blazers","360","837","156","405","204","432","163","178","22","145","167","255","23","5","126","98","1039"
"simpsza01","466","Zavier Simpson","PG","26","Memphis Grizzlies","17","54","5","17","12","37","3","4","4","16","20","25","7","3","10","11","42"
"simsje01","467","Jericho Sims","C","25","New York Knicks","38","55","0","0","38","55","16","24","56","91","147","25","8","19","16","45","92"
"skapidm01","468","Dmytro Skapintsev","C","25","New York Knicks","0","1","0","0","0","1","0","0","0","0","0","0","0","0","0","0","0"
"slawsja01","469","Jalen Slawson","SF","24","Sacramento Kings","4","6","0","2","4","4","0","0","1","6","7","2","1","1","2","8","8"
"smartja01","470","Javonte Smart","PG","24","Philadelphia 76ers","0","0","0","0","0","0","0","0","0","0","0","0","0","0","0","0","0"
"smartma01","471","Marcus Smart","PG","29","Memphis Grizzlies","102","237","42","134","60","103","43","56","6","47","53","86","41","5","62","53","289"
"smithde03","472","Dennis Smith Jr.","PG","26","Brooklyn Nets","147","338","32","109","115","229","43","58","50","114","164","203","68","12","68","121","369"
"smithdr01","473","Dru Smith","SG","26","Miami Heat","15","33","7","17","8","16","2","2","6","8","14","14","9","3","5","12","39"
"smithis01","474","Ish Smith","PG","35","Charlotte Hornets","66","158","4","8","62","150","3","4","11","65","76","145","17","4","47","49","139"
"smithja05","475","Jabari Smith Jr.","PF","20","Houston Rockets","378","833","138","380","240","453","150","185","139","477","616","121","52","61","89","200","1044"
"smithja04","476","Jalen Smith","C","23","Indiana Pacers","234","395","61","144","173","251","72","104","112","225","337","63","17","38","44","124","601"
"smithni01","477","Nick Smith Jr.","SG","19","Charlotte Hornets","113","289","63","146","50","143","13","15","18","54","72","59","10","7","39","55","302"
"smithte01","478","Terquavion Smith","PG","21","Philadelphia 76ers","18","46","13","35","5","11","3","5","0","4","4","12","8","0","7","8","52"
"sochaje01","479","Jeremy Sochan","PF","20","San Antonio Spurs","340","776","70","227","270","549","111","144","137","339","476","249","62","40","140","168","861"
"spencpa01","480","Pat Spencer","PG","27","Golden State Warriors","2","4","0","2","2","2","0","0","2","2","4","5","0","0","1","1","4"
"sprinja01","481","Jaden Springer","SG","21","Philadelphia 76ers","46","118","8","37","38","81","28","34","25","33","58","35","25","11","26","49","128"
"sprinja01","481","Jaden Springer","PG","21","Boston Celtics","13","30","2","11","11","19","7","8","8","12","20","9","11","4","8","17","35"
"stevela01","482","Lamar Stevens","PF","26","Boston Celtics","21","45","3","8","18","37","8","11","12","19","31","8","6","5","9","14","53"
"stevela01","482","Lamar Stevens","PF","26","Memphis Grizzlies","87","195","11","38","76","157","34","43","24","72","96","20","17","17","15","31","219"
"stewais01","483","Isaiah Stewart","PF","22","Detroit Pistons","186","382","67","175","119","207","64","85","74","231","305","73","17","38","66","99","503"
"strawju01","484","Julian Strawther","SF","21","Denver Nuggets","82","222","41","138","41","84","22","31","5","56","61","47","17","7","23","54","227"
"strusma01","485","Max Strus","SF","27","Cleveland Cavaliers","304","728","168","479","136","249","77","97","66","272","338","283","64","29","112","170","853"
"suggsja01","486","Jalen Suggs","SG","22","Orlando Magic","336","714","153","385","183","329","118","156","48","181","229","205","106","47","132","205","943"
"swideco01","487","Cole Swider","SF","24","Miami Heat","15","38","10","30","5","8","2","2","1","6","7","5","1","1","8","4","42"
"tateja01","488","JaeSean Tate","SF","28","Houston Rockets","108","229","23","77","85","152","26","39","61","136","197","64","42","15","37","137","265"
"tatumja01","489","Jayson Tatum","PF","25","Boston Celtics","672","1426","229","609","443","817","414","497","67","534","601","364","75","43","188","145","1987"
"taylote01","490","Terry Taylor","PF","24","Chicago Bulls","20","39","2","9","18","30","4","5","17","20","37","10","5","2","7","17","46"
"templga01","491","Garrett Temple","SG","37","Toronto Raptors","29","78","12","40","17","38","18","22","18","27","45","28","12","3","14","28","88"
"terryda01","492","Dalen Terry","SG","21","Chicago Bulls","69","157","17","74","52","83","25","43","29","84","113","81","27","18","32","81","180"
"theisda01","493","Daniel Theis","C","31","Indiana Pacers","1","4","0","1","1","3","0","0","0","0","0","0","0","0","0","1","2"
"theisda01","493","Daniel Theis","C","31","Los Angeles Clippers","155","289","26","70","129","219","38","50","85","159","244","61","21","51","42","126","374"
"thomaca02","494","Cam Thomas","SG","22","Brooklyn Nets","526","1190","144","396","382","794","286","334","28","186","214","192","45","16","124","138","1482"
"thomais02","495","Isaiah Thomas","PG","34","Phoenix Suns","3","10","2","4","1","6","0","0","0","0","0","3","0","0","0","0","8"
"thompam01","496","Amen Thompson","SF","21","Houston Rockets","239","446","8","58","231","388","106","155","148","261","409","163","78","38","90","141","592"
"thompau01","497","Ausar Thompson","SF","21","Detroit Pistons","232","480","21","113","211","367","71","119","129","273","402","120","68","59","84","175","556"
"thompkl01","498","Klay Thompson","SF","33","Golden State Warriors","490","1133","268","692","222","441","127","137","35","219","254","176","50","35","117","127","1375"
"thomptr01","499","Tristan Thompson","C","32","Cleveland Cavaliers","73","120","0","1","73","119","15","52","73","101","174","51","12","14","29","59","161"
"thorjt01","500","JT Thor","PF","21","Charlotte Hornets","80","183","28","81","52","102","11","20","43","103","146","29","11","27","15","60","199"
"thybuma01","501","Matisse Thybulle","SF","26","Portland Trail Blazers","126","317","80","231","46","86","22","29","30","106","136","90","113","49","40","93","354"
"tillmxa01","502","Xavier Tillman Sr.","C","25","Memphis Grizzlies","87","213","12","53","75","160","18","43","56","101","157","57","42","35","29","60","204"
"tillmxa01","502","Xavier Tillman Sr.","PF","25","Boston Celtics","34","66","8","28","26","38","4","7","14","40","54","20","9","9","5","15","80"
"toppija01","503","Jacob Toppin","SF","23","New York Knicks","5","9","1","4","4","5","2","2","3","4","7","3","0","1","1","3","13"
"toppiob01","504","Obi Toppin","PF","25","Indiana Pacers","332","579","102","253","230","326","77","100","85","235","320","128","47","43","69","143","843"
"toscaju01","505","Juan Toscano-Anderson","SF","30","Sacramento Kings","3","12","1","4","2","8","0","0","4","10","14","4","1","1","2","11","7"
"townska01","506","Karl-Anthony Towns","PF","28","Minnesota Timberwolves","479","951","136","327","343","624","255","292","94","421","515","189","43","41","177","204","1349"
"trentga02","507","Gary Trent Jr.","SG","25","Toronto Raptors","361","847","178","453","183","394","74","96","25","163","188","119","77","10","47","96","974"
"tshieos01","508","Oscar Tshiebwe","PF","24","Indiana Pacers","10","20","0","0","10","20","6","8","8","8","16","2","2","1","0","3","26"
"tuckepj01","509","P.J. Tucker","PF","38","Philadelphia 76ers","2","5","2","5","0","0","0","0","1","13","14","0","3","2","2","9","6"
"tuckepj01","509","P.J. Tucker","PF","38","Los Angeles Clippers","16","45","11","30","5","15","3","3","27","44","71","16","13","5","6","45","46"
"turnemy01","510","Myles Turner","C","27","Indiana Pacers","476","909","116","324","360","585","245","317","113","420","533","100","39","144","109","232","1313"
"tysonhu01","511","Hunter Tyson","PF","23","Denver Nuggets","8","20","4","14","4","6","0","0","1","8","9","2","1","0","2","10","20"
"umudest01","512","Stanley Umude","SG","24","Detroit Pistons","37","84","24","53","13","31","29","32","8","43","51","11","8","7","14","40","127"
"valanjo01","513","Jonas Valanciunas","C","31","New Orleans Pelicans","402","719","37","120","365","599","161","205","186","535","721","173","32","68","111","218","1002"
"vandeja01","514","Jarred Vanderbilt","PF","24","Los Angeles Lakers","59","114","8","27","51","87","24","36","41","97","138","36","36","5","28","43","150"
"vanvlfr01","515","Fred VanVleet","PG","29","Houston Rockets","423","1018","227","586","196","432","197","229","33","245","278","589","101","59","126","183","1270"
"vassede01","516","Devin Vassell","SG","23","San Antonio Spurs","498","1056","166","446","332","610","161","201","27","234","261","277","73","23","108","74","1323"
"vezenal01","517","Sasha Vezenkov","PF","28","Sacramento Kings","84","191","45","120","39","71","12","15","30","66","96","19","20","7","12","42","225"
"vincega01","518","Gabe Vincent","PG","27","Los Angeles Lakers","15","49","3","28","12","21","1","2","4","5","9","21","9","0","5","19","34"
"vucevni01","519","Nikola Vucevic","C","33","Chicago Bulls","586","1211","92","313","494","898","106","129","210","591","801","254","50","60","120","190","1370"
"vukcetr01","520","Tristan Vukcevic","C","20","Washington Wizards","29","67","10","36","19","31","17","22","6","30","36","13","5","7","10","28","85"
"wadede01","521","Dean Wade","PF","27","Cleveland Cavaliers","96","232","79","202","17","30","20","26","37","181","218","43","40","25","20","93","291"
"wagnefr01","522","Franz Wagner","SF","22","Orlando Magic","528","1096","94","334","434","762","271","319","72","309","381","269","76","28","137","168","1421"
"wagnemo01","523","Moritz Wagner","C","26","Orlando Magic","332","552","38","115","294","437","166","204","117","230","347","96","39","21","97","160","868"
"wainris01","524","Ish Wainright","SF","29","Portland Trail Blazers","6","18","6","16","0","2","2","2","0","9","9","0","2","1","1","4","20"
"wainris01","524","Ish Wainright","SF","29","Phoenix Suns","1","6","1","4","0","2","0","0","3","2","5","1","2","0","1","4","3"
"walkeja01","525","Jabari Walker","SF","21","Portland Trail Blazers","234","509","41","139","193","370","129","171","151","357","508","71","42","22","66","173","638"
"walkeja02","526","Jarace Walker","PF","20","Indiana Pacers","45","110","22","55","23","55","8","9","12","51","63","40","15","11","17","29","120"
"walkelo01","527","Lonnie Walker IV","SG","25","Brooklyn Nets","208","492","104","271","104","221","45","59","13","114","127","74","32","20","51","71","565"
"wallaca01","528","Cason Wallace","SG","20","Oklahoma City Thunder","217","442","98","234","119","208","29","37","52","135","187","120","76","37","45","129","561"
"walshjo01","529","Jordan Walsh","SF","19","Boston Celtics","6","15","2","9","4","6","1","2","5","15","20","5","5","1","3","11","15"
"warretj01","530","T.J. Warren","SF","30","Minnesota Timberwolves","18","41","2","13","16","28","3","4","5","17","22","9","4","1","4","11","41"
"washipj01","531","P.J. Washington","PF","25","Charlotte Hornets","227","509","79","244","148","265","67","94","53","179","232","97","38","32","66","112","600"
"washipj01","531","P.J. Washington","PF","25","Dallas Mavericks","127","302","53","169","74","133","32","51","32","147","179","44","34","27","30","57","339"
"washity02","532","TyTy Washington Jr.","PG","22","Milwaukee Bucks","6","20","2","6","4","14","0","0","1","4","5","5","3","0","2","1","14"
"watanyu01","533","Yuta Watanabe","SF","29","Phoenix Suns","35","97","24","75","11","22","10","15","11","34","45","10","9","7","16","34","104"
"watanyu01","533","Yuta Watanabe","SF","29","Memphis Grizzlies","6","19","1","10","5","9","0","2","0","9","9","5","3","0","3","5","13"
"waterli01","534","Lindy Waters III","SG","26","Oklahoma City Thunder","49","104","37","85","12","19","2","2","7","33","40","24","5","7","7","23","137"
"watfotr01","535","Trendon Watford","PF","23","Brooklyn Nets","164","311","27","68","137","243","77","97","52","142","194","81","23","19","63","106","432"
"watsope01","536","Peyton Watson","SF","21","Denver Nuggets","208","447","45","152","163","295","71","106","56","202","258","86","42","88","58","143","532"
"wembavi01","537","Victor Wembanyama","C","20","San Antonio Spurs","551","1186","128","394","423","792","292","367","161","594","755","274","88","254","260","153","1522"
"weslebl01","538","Blake Wesley","SG","20","San Antonio Spurs","102","215","12","55","90","160","52","78","18","76","94","166","29","9","55","89","268"
"westbru01","539","Russell Westbrook","PG","35","Los Angeles Clippers","301","663","42","154","259","509","110","160","93","250","343","306","74","23","144","121","754"
"whiteco01","540","Coby White","PG","23","Chicago Bulls","541","1209","209","556","332","653","218","260","44","314","358","405","53","18","166","186","1509"
"whitede01","541","Derrick White","SG","29","Boston Celtics","387","839","196","495","191","344","137","152","51","259","310","377","74","87","112","152","1107"
"whiteja03","542","Jack White","SF","26","Memphis Grizzlies","2","16","2","10","0","6","0","0","4","8","12","1","4","1","2","3","6"
"whitmca01","543","Cam Whitmore","SF","19","Houston Rockets","212","467","79","220","133","247","76","112","44","136","180","33","30","17","46","64","579"
"wiggiaa01","544","Aaron Wiggins","SG","25","Oklahoma City Thunder","212","377","62","126","150","251","56","71","60","126","186","86","56","19","56","91","542"
"wiggian01","545","Andrew Wiggins","SF","28","Golden State Warriors","353","780","91","254","262","526","142","189","108","213","321","119","42","41","87","147","939"
"wiggili01","546","Lindell Wigginton","PG","25","Milwaukee Bucks","2","5","0","2","2","3","2","2","0","0","0","0","0","0","1","1","6"
"willial06","547","Alondes Williams","SG","24","Miami Heat","2","8","0","4","2","4","1","1","0","1","1","0","0","1","2","2","5"
"willibr03","548","Brandon Williams","PG","24","Dallas Mavericks","20","54","3","15","17","39","11","17","4","9","13","17","1","1","7","4","54"
"willigr01","549","Grant Williams","PF","25","Dallas Mavericks","131","317","79","210","52","107","41","55","46","123","169","81","24","27","53","137","382"
"willigr01","549","Grant Williams","PF","25","Charlotte Hornets","145","288","47","126","98","162","65","85","40","109","149","93","20","12","56","89","402"
"willija06","550","Jalen Williams","PF","22","Oklahoma City Thunder","536","993","103","241","433","752","180","221","37","245","282","322","80","45","123","175","1355"
"willija07","551","Jaylin Williams","C","21","Oklahoma City Thunder","95","228","53","144","42","84","33","41","36","198","234","110","28","27","34","98","276"
"willije02","552","Jeenathan Williams","SG","24","Houston Rockets","27","50","2","5","25","45","7","13","12","11","23","7","4","1","4","10","63"
"willike04","553","Kenrich Williams","PF","29","Oklahoma City Thunder","131","280","56","141","75","139","7","14","61","148","209","93","38","9","32","101","325"
"willima11","554","Malik Williams","C","25","Toronto Raptors","9","34","1","5","8","29","0","2","15","23","38","2","3","4","3","15","19"
"willima07","555","Mark Williams","C","22","Charlotte Hornets","98","151","0","0","98","151","46","64","76","108","184","22","16","20","17","50","242"
"willipa01","556","Patrick Williams","PF","22","Chicago Bulls","159","359","59","148","100","211","52","66","46","120","166","66","40","33","57","87","429"
"williro04","557","Robert Williams","C","26","Portland Trail Blazers","17","26","0","0","17","26","7","9","11","27","38","5","7","7","7","17","41"
"willivi01","558","Vince Williams Jr.","SG","23","Memphis Grizzlies","169","379","79","209","90","170","104","130","59","231","290","175","47","34","92","135","521"
"willizi02","559","Ziaire Williams","SF","22","Memphis Grizzlies","150","378","58","189","92","189","62","75","35","145","180","75","36","9","66","85","420"
"willizi01","560","Zion Williamson","PF","23","New Orleans Pelicans","624","1094","6","18","618","1076","347","494","122","284","406","352","77","47","193","159","1601"
"wilsodj01","561","D.J. Wilson","PF","27","Philadelphia 76ers","4","6","2","2","2","4","0","0","1","1","2","2","0","2","0","1","10"
"wilsoja03","562","Jalen Wilson","PF","23","Brooklyn Nets","76","179","24","74","52","105","38","46","47","84","131","45","11","4","19","48","214"
"windldy01","563","Dylan Windler","SF","27","New York Knicks","1","2","1","2","0","0","0","0","0","1","1","1","0","0","0","1","3"
"windldy01","563","Dylan Windler","SF","27","Los Angeles Lakers","4","9","4","8","0","1","0","0","0","3","3","6","0","0","0","2","12"
"windldy01","563","Dylan Windler","SF","27","Atlanta Hawks","10","19","8","17","2","2","0","0","3","9","12","3","2","0","2","3","28"
"wisemja01","564","James Wiseman","C","22","Detroit Pistons","187","305","0","2","187","303","72","102","110","226","336","54","12","39","66","141","446"
"wongis01","565","Isaiah Wong","SG","23","Indiana Pacers","1","3","0","1","1","2","0","0","0","0","0","0","0","0","0","0","2"
"woodch01","566","Christian Wood","PF","28","Los Angeles Lakers","123","264","35","114","88","150","66","94","39","215","254","49","16","33","50","72","347"
"wrighde01","567","Delon Wright","PG","31","Washington Wizards","48","122","14","38","34","84","24","29","13","46","59","82","35","8","11","22","134"
"wrighde01","567","Delon Wright","PG","31","Miami Heat","26","66","11","30","15","36","13","16","6","21","27","37","19","3","3","10","76"
"youngth01","568","Thaddeus Young","PF","35","Toronto Raptors","54","87","1","6","53","81","5","12","29","46","75","50","18","3","11","38","114"
"youngth01","568","Thaddeus Young","PF","35","Phoenix Suns","11","21","0","1","11","20","1","3","17","11","28","7","5","2","4","11","23"
"youngtr01","569","Trae Young","PG","25","Atlanta Hawks","433","1008","175","469","258","539","348","407","23","126","149","583","72","11","235","109","1389"
"yurtsom01","570","Omer Yurtseven","C","25","Utah Jazz","99","184","5","24","94","160","19","28","72","136","208","29","8","18","37","52","222"
"zelleco01","571","Cody Zeller","C","31","New Orleans Pelicans","26","62","1","3","25","59","23","38","48","64","112","39","9","5","16","45","76"
"zubaciv01","572","Ivica Zubac","C","26","Los Angeles Clippers","337","519","0","0","337","519","120","166","196","430","626","93","22","83","79","180","794"
